edition,edition_id,country,country noc,number_of_athletes,number_of_gold,number_of_silver,number_of_bronze,total_medals
1896 Summer Olympics,1,Australia,AUS,2,2,0,2,4
1896 Summer Olympics,1,Austria,AUT,3,2,1,2,5
1896 Summer Olympics,1,Bulgaria,BUL,1,0,0,0,0
1896 Summer Olympics,1,Denmark,DEN,4,1,2,3,6
1896 Summer Olympics,1,France,FRA,18,5,4,2,11
1896 Summer Olympics,1,Great Britain,GBR,15,4,3,4,11
1896 Summer Olympics,1,Germany,GER,20,26,5,2,33
1896 Summer Olympics,1,Greece,GRE,138,10,21,21,52
1896 Summer Olympics,1,Hungary,HUN,14,2,1,3,6
1896 Summer Olympics,1,Italy,ITA,5,0,0,0,0
1896 Summer Olympics,1,Switzerland,SUI,2,1,2,0,3
1896 Summer Olympics,1,Sweden,SWE,3,0,0,0,0
1896 Summer Olympics,1,United States,USA,22,11,7,2,20
1900 Summer Olympics,2,Argentina,ARG,3,0,0,0,0
1900 Summer Olympics,2,Australia,AUS,2,0,0,3,3
1900 Summer Olympics,2,Austria,AUT,20,0,3,3,6
1900 Summer Olympics,2,Belgium,BEL,98,6,23,16,45
1900 Summer Olympics,2,Bohemia,BOH,11,0,1,3,4
1900 Summer Olympics,2,Cuba,CUB,1,1,1,0,2
1900 Summer Olympics,2,Denmark,DEN,16,7,3,2,12
1900 Summer Olympics,2,Spain,ESP,30,2,0,0,2
1900 Summer Olympics,2,France,FRA,1466,57,113,88,258
1900 Summer Olympics,2,Great Britain,GBR,200,73,27,12,112
1900 Summer Olympics,2,Germany,GER,95,15,20,11,46
1900 Summer Olympics,2,Greece,GRE,2,0,0,0,0
1900 Summer Olympics,2,Haiti,HAI,2,0,0,0,0
1900 Summer Olympics,2,Hungary,HUN,38,1,2,2,5
1900 Summer Olympics,2,India,IND,1,0,2,0,2
1900 Summer Olympics,2,Islamic Republic of Iran,IRI,1,0,0,0,0
1900 Summer Olympics,2,Italy,ITA,43,3,2,0,5
1900 Summer Olympics,2,Mexico,MEX,21,0,0,4,4
1900 Summer Olympics,2,Netherlands,NED,44,3,8,15,26
1900 Summer Olympics,2,Norway,NOR,7,0,6,3,9
1900 Summer Olympics,2,Peru,PER,6,0,0,0,0
1900 Summer Olympics,2,Romania,ROU,1,0,0,0,0
1900 Summer Olympics,2,Russian Federation,RUS,6,0,0,0,0
1900 Summer Olympics,2,Switzerland,SUI,30,16,5,1,22
1900 Summer Olympics,2,Sweden,SWE,13,6,0,1,7
1900 Summer Olympics,2,Unknown,UNK,4,0,0,0,0
1900 Summer Olympics,2,United States,USA,128,28,15,21,64
1904 Summer Olympics,3,Australia,AUS,6,0,0,0,0
1904 Summer Olympics,3,Canada,CAN,64,28,10,12,50
1904 Summer Olympics,3,Cuba,CUB,4,6,0,0,6
1904 Summer Olympics,3,Great Britain,GBR,5,1,1,0,2
1904 Summer Olympics,3,Germany,GER,21,5,4,5,14
1904 Summer Olympics,3,Greece,GRE,15,1,0,1,2
1904 Summer Olympics,3,Hungary,HUN,4,2,1,1,4
1904 Summer Olympics,3,Italy,ITA,1,0,0,0,0
1904 Summer Olympics,3,South Africa,RSA,8,0,0,0,0
1904 Summer Olympics,3,United States,USA,1245,138,149,135,422
1906  Intercalated Games,4,Crete,CRT,8,0,0,0,0
1908 Summer Olympics,5,Australasia,ANZ,47,31,2,2,35
1908 Summer Olympics,5,Argentina,ARG,1,0,0,0,0
1908 Summer Olympics,5,Austria,AUT,21,0,0,1,1
1908 Summer Olympics,5,Belgium,BEL,83,1,29,8,38
1908 Summer Olympics,5,Bohemia,BOH,26,0,0,6,6
1908 Summer Olympics,5,Canada,CAN,93,17,8,32,57
1908 Summer Olympics,5,Denmark,DEN,84,0,18,3,21
1908 Summer Olympics,5,Finland,FIN,63,1,1,28,30
1908 Summer Olympics,5,France,FRA,283,12,5,23,40
1908 Summer Olympics,5,Great Britain,GBR,800,180,135,96,411
1908 Summer Olympics,5,Germany,GER,109,4,11,6,21
1908 Summer Olympics,5,Greece,GRE,20,0,3,1,4
1908 Summer Olympics,5,Hungary,HUN,133,7,7,6,20
1908 Summer Olympics,5,Iceland,ISL,5,0,0,0,0
1908 Summer Olympics,5,Italy,ITA,79,2,6,0,8
1908 Summer Olympics,5,Netherlands,NED,137,0,0,34,34
1908 Summer Olympics,5,Norway,NOR,74,7,32,3,42
1908 Summer Olympics,5,South Africa,RSA,18,1,1,0,2
1908 Summer Olympics,5,Russian Federation,RUS,7,1,2,0,3
1908 Summer Olympics,5,Switzerland,SUI,4,0,0,0,0
1908 Summer Olympics,5,Sweden,SWE,183,48,18,18,84
1908 Summer Olympics,5,Türkiye,TUR,1,0,0,0,0
1908 Summer Olympics,5,United States,USA,152,34,16,15,65
1912 Summer Olympics,6,Australasia,ANZ,26,5,2,3,10
1912 Summer Olympics,6,Austria,AUT,114,0,10,5,15
1912 Summer Olympics,6,Belgium,BEL,43,9,1,11,21
1912 Summer Olympics,6,Bohemia,BOH,55,0,0,0,0
1912 Summer Olympics,6,Canada,CAN,38,3,2,3,8
1912 Summer Olympics,6,Chile,CHI,14,0,0,0,0
1912 Summer Olympics,6,Denmark,DEN,163,5,54,33,92
1912 Summer Olympics,6,Finland,FIN,168,9,40,22,71
1912 Summer Olympics,6,France,FRA,224,10,11,5,26
1912 Summer Olympics,6,Great Britain,GBR,323,67,66,66,199
1912 Summer Olympics,6,Germany,GER,193,11,19,23,53
1912 Summer Olympics,6,Greece,GRE,33,1,0,1,2
1912 Summer Olympics,6,Hungary,HUN,184,10,20,3,33
1912 Summer Olympics,6,Iceland,ISL,6,0,0,0,0
1912 Summer Olympics,6,Italy,ITA,98,22,1,2,25
1912 Summer Olympics,6,Japan,JPN,2,0,0,0,0
1912 Summer Olympics,6,Luxembourg,LUX,22,0,0,0,0
1912 Summer Olympics,6,Netherlands,NED,41,0,0,35,35
1912 Summer Olympics,6,Norway,NOR,208,39,7,34,80
1912 Summer Olympics,6,Poland,POL,1,0,0,0,0
1912 Summer Olympics,6,Portugal,POR,8,0,0,0,0
1912 Summer Olympics,6,South Africa,RSA,21,5,2,0,7
1912 Summer Olympics,6,Russian Federation,RUS,180,0,5,9,14
1912 Summer Olympics,6,Serbia,SRB,3,0,0,0,0
1912 Summer Olympics,6,Switzerland,SUI,7,1,0,0,1
1912 Summer Olympics,6,Sweden,SWE,488,102,63,25,190
1912 Summer Olympics,6,Türkiye,TUR,2,0,0,0,0
1912 Summer Olympics,6,Unknown,UNK,2,0,0,0,0
1912 Summer Olympics,6,United States,USA,221,46,25,36,107
1920 Summer Olympics,7,Argentina,ARG,1,0,0,0,0
1920 Summer Olympics,7,Australia,AUS,14,0,6,1,7
1920 Summer Olympics,7,Belgium,BEL,350,65,65,68,198
1920 Summer Olympics,7,Brazil,BRA,19,1,1,5,7
1920 Summer Olympics,7,Canada,CAN,55,10,3,3,16
1920 Summer Olympics,7,Chile,CHI,2,0,0,0,0
1920 Summer Olympics,7,Denmark,DEN,169,26,46,1,73
1920 Summer Olympics,7,Egypt,EGY,23,0,0,0,0
1920 Summer Olympics,7,Spain,ESP,65,0,27,0,27
1920 Summer Olympics,7,Estonia,EST,14,1,2,0,3
1920 Summer Olympics,7,Finland,FIN,62,21,14,17,52
1920 Summer Olympics,7,France,FRA,338,13,79,57,149
1920 Summer Olympics,7,Great Britain,GBR,245,54,41,17,112
1920 Summer Olympics,7,Greece,GRE,54,0,5,0,5
1920 Summer Olympics,7,India,IND,6,0,0,0,0
1920 Summer Olympics,7,Italy,ITA,181,67,10,8,85
1920 Summer Olympics,7,Japan,JPN,15,0,3,0,3
1920 Summer Olympics,7,Luxembourg,LUX,30,0,1,0,1
1920 Summer Olympics,7,Monaco,MON,4,0,0,0,0
1920 Summer Olympics,7,Netherlands,NED,175,15,10,33,58
1920 Summer Olympics,7,Norway,NOR,198,58,53,27,138
1920 Summer Olympics,7,New Zealand,NZL,4,0,0,1,1
1920 Summer Olympics,7,Portugal,POR,13,0,0,0,0
1920 Summer Olympics,7,South Africa,RSA,39,3,12,6,21
1920 Summer Olympics,7,Switzerland,SUI,82,6,2,21,29
1920 Summer Olympics,7,Sweden,SWE,271,53,38,64,155
1920 Summer Olympics,7,Czechoslovakia,TCH,133,0,0,11,11
1920 Summer Olympics,7,United States,USA,299,116,45,38,199
1920 Summer Olympics,7,Yugoslavia,YUG,18,0,0,0,0
1924 Summer Olympics,8,Argentina,ARG,83,6,3,2,11
1924 Summer Olympics,8,Australia,AUS,39,3,5,2,10
1924 Summer Olympics,8,Austria,AUT,83,0,3,1,4
1924 Summer Olympics,8,Belgium,BEL,206,3,34,6,43
1924 Summer Olympics,8,Brazil,BRA,14,0,0,0,0
1924 Summer Olympics,8,Bulgaria,BUL,36,0,0,0,0
1924 Summer Olympics,8,Canada,CAN,74,0,21,1,22
1924 Summer Olympics,8,Chile,CHI,15,0,0,0,0
1924 Summer Olympics,8,Cuba,CUB,23,0,0,0,0
1924 Summer Olympics,8,Denmark,DEN,101,2,9,3,14
1924 Summer Olympics,8,Ecuador,ECU,3,0,0,0,0
1924 Summer Olympics,8,Egypt,EGY,34,0,0,0,0
1924 Summer Olympics,8,Spain,ESP,145,0,0,0,0
1924 Summer Olympics,8,Estonia,EST,51,1,1,4,6
1924 Summer Olympics,8,Finland,FIN,124,24,13,15,52
1924 Summer Olympics,8,France,FRA,475,42,61,22,125
1924 Summer Olympics,8,Great Britain,GBR,294,15,35,23,73
1924 Summer Olympics,8,Greece,GRE,47,1,0,0,1
1924 Summer Olympics,8,Haiti,HAI,9,0,0,5,5
1924 Summer Olympics,8,Hungary,HUN,140,2,11,9,22
1924 Summer Olympics,8,India,IND,17,0,0,0,0
1924 Summer Olympics,8,Ireland,IRL,64,0,1,1,2
1924 Summer Olympics,8,Italy,ITA,241,25,5,22,52
1924 Summer Olympics,8,Japan,JPN,19,0,0,1,1
1924 Summer Olympics,8,Latvia,LAT,49,0,0,0,0
1924 Summer Olympics,8,Lithuania,LTU,20,0,0,0,0
1924 Summer Olympics,8,Luxembourg,LUX,66,1,1,0,2
1924 Summer Olympics,8,Mexico,MEX,16,0,0,0,0
1924 Summer Olympics,8,Monaco,MON,7,0,0,1,1
1924 Summer Olympics,8,Netherlands,NED,197,8,1,22,31
1924 Summer Olympics,8,Norway,NOR,80,14,5,3,22
1924 Summer Olympics,8,New Zealand,NZL,4,0,0,1,1
1924 Summer Olympics,8,Philippines,PHI,3,0,0,0,0
1924 Summer Olympics,8,Poland,POL,83,0,4,1,5
1924 Summer Olympics,8,Portugal,POR,30,0,0,4,4
1924 Summer Olympics,8,Romania,ROU,53,0,0,22,22
1924 Summer Olympics,8,South Africa,RSA,31,1,1,1,3
1924 Summer Olympics,8,Russian Federation,RUS,4,0,0,0,0
1924 Summer Olympics,8,Switzerland,SUI,159,15,32,21,68
1924 Summer Olympics,8,Sweden,SWE,174,7,24,47,78
1924 Summer Olympics,8,Czechoslovakia,TCH,186,1,4,5,10
1924 Summer Olympics,8,Türkiye,TUR,39,0,0,0,0
1924 Summer Olympics,8,Uruguay,URU,38,22,0,0,22
1924 Summer Olympics,8,United States,USA,336,116,36,52,204
1924 Summer Olympics,8,Yugoslavia,YUG,58,2,0,0,2
1924 Winter Olympics,29,Australia,AUS,21,21,0,0,21
1924 Winter Olympics,29,Austria,AUT,4,3,1,0,4
1924 Winter Olympics,29,Belgium,BEL,26,0,0,5,5
1924 Winter Olympics,29,Canada,CAN,13,10,0,0,10
1924 Winter Olympics,29,Finland,FIN,18,4,8,3,15
1924 Winter Olympics,29,France,FRA,49,0,0,12,12
1924 Winter Olympics,29,Great Britain,GBR,64,30,4,13,47
1924 Winter Olympics,29,Hungary,HUN,6,0,0,0,0
1924 Winter Olympics,29,India,IND,21,21,0,0,21
1924 Winter Olympics,29,Italy,ITA,26,0,0,0,0
1924 Winter Olympics,29,Latvia,LAT,2,0,0,0,0
1924 Winter Olympics,29,Nepal,NEP,21,21,0,0,21
1924 Winter Olympics,29,Norway,NOR,14,4,7,6,17
1924 Winter Olympics,29,Poland,POL,10,0,0,0,0
1924 Winter Olympics,29,Switzerland,SUI,42,8,0,1,9
1924 Winter Olympics,29,Sweden,SWE,40,1,8,0,9
1924 Winter Olympics,29,Czechoslovakia,TCH,30,0,0,0,0
1924 Winter Olympics,29,United States,USA,25,1,11,1,13
1924 Winter Olympics,29,Yugoslavia,YUG,6,0,0,0,0
1928 Summer Olympics,9,Argentina,ARG,95,3,24,5,32
1928 Summer Olympics,9,Australia,AUS,19,1,2,1,4
1928 Summer Olympics,9,Austria,AUT,80,3,0,2,5
1928 Summer Olympics,9,Belgium,BEL,212,0,1,5,6
1928 Summer Olympics,9,Bulgaria,BUL,5,0,0,0,0
1928 Summer Olympics,9,Canada,CAN,86,8,6,26,40
1928 Summer Olympics,9,Chile,CHI,48,0,1,0,1
1928 Summer Olympics,9,Cuba,CUB,1,0,0,0,0
1928 Summer Olympics,9,Denmark,DEN,94,6,5,4,15
1928 Summer Olympics,9,Egypt,EGY,37,2,1,1,4
1928 Summer Olympics,9,Spain,ESP,93,3,0,0,3
1928 Summer Olympics,9,Estonia,EST,25,2,1,6,9
1928 Summer Olympics,9,Finland,FIN,82,8,8,9,25
1928 Summer Olympics,9,France,FRA,345,12,25,14,51
1928 Summer Olympics,9,Great Britain,GBR,264,8,27,28,63
1928 Summer Olympics,9,Germany,GER,321,24,21,48,93
1928 Summer Olympics,9,Greece,GRE,28,0,0,0,0
1928 Summer Olympics,9,Haiti,HAI,2,0,1,0,1
1928 Summer Olympics,9,Hungary,HUN,134,10,15,0,25
1928 Summer Olympics,9,India,IND,23,15,0,0,15
1928 Summer Olympics,9,Ireland,IRL,40,1,0,0,1
1928 Summer Olympics,9,Italy,ITA,195,24,22,31,77
1928 Summer Olympics,9,Japan,JPN,43,2,6,1,9
1928 Summer Olympics,9,Latvia,LAT,19,0,0,0,0
1928 Summer Olympics,9,Lithuania,LTU,13,0,0,0,0
1928 Summer Olympics,9,Luxembourg,LUX,66,1,0,0,1
1928 Summer Olympics,9,Mexico,MEX,36,0,0,0,0
1928 Summer Olympics,9,Malta,MLT,9,0,0,0,0
1928 Summer Olympics,9,Monaco,MON,12,0,0,0,0
1928 Summer Olympics,9,Netherlands,NED,342,20,40,7,67
1928 Summer Olympics,9,Norway,NOR,63,4,4,1,9
1928 Summer Olympics,9,New Zealand,NZL,10,1,0,0,1
1928 Summer Olympics,9,Panama,PAN,1,0,0,0,0
1928 Summer Olympics,9,Philippines,PHI,4,0,0,1,1
1928 Summer Olympics,9,Poland,POL,105,2,3,17,22
1928 Summer Olympics,9,Portugal,POR,44,0,0,6,6
1928 Summer Olympics,9,Romania,ROU,21,0,0,0,0
1928 Summer Olympics,9,South Africa,RSA,25,1,0,6,7
1928 Summer Olympics,9,Switzerland,SUI,165,18,13,4,35
1928 Summer Olympics,9,Sweden,SWE,106,7,8,22,37
1928 Summer Olympics,9,Czechoslovakia,TCH,80,2,12,2,16
1928 Summer Olympics,9,Türkiye,TUR,42,0,0,0,0
1928 Summer Olympics,9,Uruguay,URU,22,22,0,0,22
1928 Summer Olympics,9,United States,USA,316,58,29,17,104
1928 Summer Olympics,9,Yugoslavia,YUG,53,1,1,10,12
1928 Summer Olympics,9,Zimbabwe,ZIM,2,0,0,0,0
1928 Winter Olympics,30,Argentina,ARG,10,0,0,0,0
1928 Winter Olympics,30,Austria,AUT,39,0,4,2,6
1928 Winter Olympics,30,Belgium,BEL,26,0,0,1,1
1928 Winter Olympics,30,Canada,CAN,24,13,0,0,13
1928 Winter Olympics,30,Estonia,EST,2,0,0,0,0
1928 Winter Olympics,30,Finland,FIN,21,2,1,1,4
1928 Winter Olympics,30,France,FRA,43,2,0,0,2
1928 Winter Olympics,30,Great Britain,GBR,34,0,0,1,1
1928 Winter Olympics,30,Germany,GER,51,0,0,5,5
1928 Winter Olympics,30,Hungary,HUN,14,0,0,0,0
1928 Winter Olympics,30,Italy,ITA,17,0,0,0,0
1928 Winter Olympics,30,Japan,JPN,6,0,0,0,0
1928 Winter Olympics,30,Latvia,LAT,1,0,0,0,0
1928 Winter Olympics,30,Lithuania,LTU,1,0,0,0,0
1928 Winter Olympics,30,Luxembourg,LUX,5,0,0,0,0
1928 Winter Olympics,30,Mexico,MEX,5,0,0,0,0
1928 Winter Olympics,30,Netherlands,NED,7,0,0,0,0
1928 Winter Olympics,30,Norway,NOR,28,6,4,5,15
1928 Winter Olympics,30,Poland,POL,28,0,0,0,0
1928 Winter Olympics,30,Romania,ROU,14,0,0,0,0
1928 Winter Olympics,30,Switzerland,SUI,50,0,0,12,12
1928 Winter Olympics,30,Sweden,SWE,24,2,13,1,16
1928 Winter Olympics,30,Czechoslovakia,TCH,40,0,0,1,1
1928 Winter Olympics,30,United States,USA,25,6,6,2,14
1928 Winter Olympics,30,Yugoslavia,YUG,6,0,0,0,0
1932 Summer Olympics,10,Argentina,ARG,35,3,1,0,4
1932 Summer Olympics,10,Australia,AUS,12,3,1,1,5
1932 Summer Olympics,10,Austria,AUT,19,1,1,3,5
1932 Summer Olympics,10,Belgium,BEL,36,0,0,1,1
1932 Summer Olympics,10,Brazil,BRA,78,0,0,0,0
1932 Summer Olympics,10,Bulgaria,BUL,2,0,0,0,0
1932 Summer Olympics,10,Canada,CAN,119,2,15,27,44
1932 Summer Olympics,10,People's Republic of China,CHN,1,0,0,0,0
1932 Summer Olympics,10,Colombia,COL,2,0,0,0,0
1932 Summer Olympics,10,Cuba,CUB,8,0,0,0,0
1932 Summer Olympics,10,Denmark,DEN,43,0,8,4,12
1932 Summer Olympics,10,El Salvador,ESA,1,0,0,0,0
1932 Summer Olympics,10,Spain,ESP,7,0,0,1,1
1932 Summer Olympics,10,Estonia,EST,2,0,0,0,0
1932 Summer Olympics,10,Finland,FIN,41,5,8,16,29
1932 Summer Olympics,10,France,FRA,103,24,8,6,38
1932 Summer Olympics,10,Great Britain,GBR,111,11,16,15,42
1932 Summer Olympics,10,Germany,GER,148,10,33,7,50
1932 Summer Olympics,10,Greece,GRE,11,0,0,0,0
1932 Summer Olympics,10,Guatemala,GUA,1,0,0,0,0
1932 Summer Olympics,10,Haiti,HAI,3,0,0,0,0
1932 Summer Olympics,10,Hungary,HUN,61,21,5,8,34
1932 Summer Olympics,10,India,IND,19,15,0,0,15
1932 Summer Olympics,10,Ireland,IRL,16,2,0,0,2
1932 Summer Olympics,10,Italy,ITA,114,22,39,21,82
1932 Summer Olympics,10,Japan,JPN,165,10,19,4,33
1932 Summer Olympics,10,Latvia,LAT,5,0,1,0,1
1932 Summer Olympics,10,Luxembourg,LUX,3,0,0,0,0
1932 Summer Olympics,10,Mexico,MEX,76,0,2,0,2
1932 Summer Olympics,10,Monaco,MON,1,0,0,0,0
1932 Summer Olympics,10,Netherlands,NED,45,2,10,1,13
1932 Summer Olympics,10,Norway,NOR,7,0,0,0,0
1932 Summer Olympics,10,New Zealand,NZL,21,0,2,0,2
1932 Summer Olympics,10,Peru,PER,2,0,0,0,0
1932 Summer Olympics,10,Philippines,PHI,8,0,0,3,3
1932 Summer Olympics,10,Poland,POL,51,3,4,14,21
1932 Summer Olympics,10,Portugal,POR,6,0,0,0,0
1932 Summer Olympics,10,Romania,ROU,1,0,0,0,0
1932 Summer Olympics,10,South Africa,RSA,12,2,0,3,5
1932 Summer Olympics,10,Switzerland,SUI,7,0,1,0,1
1932 Summer Olympics,10,Sweden,SWE,81,13,7,13,33
1932 Summer Olympics,10,Czechoslovakia,TCH,27,1,3,2,6
1932 Summer Olympics,10,Türkiye,TUR,1,0,0,0,0
1932 Summer Olympics,10,Uruguay,URU,2,0,0,1,1
1932 Summer Olympics,10,United States,USA,540,100,47,68,215
1932 Summer Olympics,10,Venezuela,VEN,1,0,0,0,0
1932 Summer Olympics,10,Yugoslavia,YUG,2,0,0,0,0
1932 Winter Olympics,31,Austria,AUT,7,1,1,0,2
1932 Winter Olympics,31,Belgium,BEL,5,0,0,0,0
1932 Winter Olympics,31,Canada,CAN,123,14,1,5,20
1932 Winter Olympics,31,Finland,FIN,8,1,1,1,3
1932 Winter Olympics,31,France,FRA,9,2,0,0,2
1932 Winter Olympics,31,Great Britain,GBR,16,0,0,0,0
1932 Winter Olympics,31,Germany,GER,30,0,0,14,14
1932 Winter Olympics,31,Hungary,HUN,4,0,0,2,2
1932 Winter Olympics,31,Italy,ITA,13,0,0,0,0
1932 Winter Olympics,31,Japan,JPN,16,0,0,0,0
1932 Winter Olympics,31,Norway,NOR,23,3,4,3,10
1932 Winter Olympics,31,Poland,POL,20,0,0,0,0
1932 Winter Olympics,31,Romania,ROU,4,0,0,0,0
1932 Winter Olympics,31,Switzerland,SUI,16,0,2,0,2
1932 Winter Olympics,31,Sweden,SWE,14,1,2,0,3
1932 Winter Olympics,31,Czechoslovakia,TCH,6,0,0,0,0
1932 Winter Olympics,31,United States,USA,142,10,21,3,34
1936 Summer Olympics,11,Afghanistan,AFG,19,0,0,0,0
1936 Summer Olympics,11,Argentina,ARG,52,5,2,4,11
1936 Summer Olympics,11,Australia,AUS,33,0,0,1,1
1936 Summer Olympics,11,Austria,AUT,264,6,49,6,61
1936 Summer Olympics,11,Belgium,BEL,170,0,0,16,16
1936 Summer Olympics,11,Bermuda,BER,7,0,0,0,0
1936 Summer Olympics,11,Bolivia,BOL,2,0,0,0,0
1936 Summer Olympics,11,Brazil,BRA,81,0,0,0,0
1936 Summer Olympics,11,Bulgaria,BUL,28,0,0,0,0
1936 Summer Olympics,11,Canada,CAN,108,1,17,11,29
1936 Summer Olympics,11,Chile,CHI,48,0,0,0,0
1936 Summer Olympics,11,People's Republic of China,CHN,69,0,0,0,0
1936 Summer Olympics,11,Colombia,COL,7,0,0,0,0
1936 Summer Olympics,11,Costa Rica,CRC,1,0,0,0,0
1936 Summer Olympics,11,Denmark,DEN,134,0,3,3,6
1936 Summer Olympics,11,Egypt,EGY,65,2,1,2,5
1936 Summer Olympics,11,Estonia,EST,36,2,2,3,7
1936 Summer Olympics,11,Finland,FIN,119,8,6,13,27
1936 Summer Olympics,11,France,FRA,236,13,13,23,49
1936 Summer Olympics,11,Great Britain,GBR,227,16,22,8,46
1936 Summer Olympics,11,Germany,GER,471,97,70,73,240
1936 Summer Olympics,11,Greece,GRE,46,0,0,0,0
1936 Summer Olympics,11,Hungary,HUN,264,25,1,17,43
1936 Summer Olympics,11,India,IND,30,22,0,0,22
1936 Summer Olympics,11,Iceland,ISL,15,0,0,0,0
1936 Summer Olympics,11,Italy,ITA,271,45,38,5,88
1936 Summer Olympics,11,Japan,JPN,240,11,4,10,25
1936 Summer Olympics,11,Latvia,LAT,35,0,1,1,2
1936 Summer Olympics,11,Liechtenstein,LIE,6,0,0,0,0
1936 Summer Olympics,11,Luxembourg,LUX,57,0,0,0,0
1936 Summer Olympics,11,Mexico,MEX,32,0,0,16,16
1936 Summer Olympics,11,Malta,MLT,14,0,0,0,0
1936 Summer Olympics,11,Monaco,MON,8,0,0,0,0
1936 Summer Olympics,11,Netherlands,NED,180,11,7,27,45
1936 Summer Olympics,11,Norway,NOR,80,1,12,23,36
1936 Summer Olympics,11,New Zealand,NZL,7,1,0,0,1
1936 Summer Olympics,11,Peru,PER,60,0,0,0,0
1936 Summer Olympics,11,Philippines,PHI,30,0,0,1,1
1936 Summer Olympics,11,Poland,POL,157,0,6,6,12
1936 Summer Olympics,11,Portugal,POR,20,0,0,3,3
1936 Summer Olympics,11,Romania,ROU,61,0,1,0,1
1936 Summer Olympics,11,South Africa,RSA,34,0,1,0,1
1936 Summer Olympics,11,Switzerland,SUI,232,5,23,25,53
1936 Summer Olympics,11,Sweden,SWE,193,7,11,17,35
1936 Summer Olympics,11,Czechoslovakia,TCH,206,5,12,1,18
1936 Summer Olympics,11,Türkiye,TUR,58,1,0,1,2
1936 Summer Olympics,11,Uruguay,URU,49,0,0,0,0
1936 Summer Olympics,11,United States,USA,407,61,33,17,111
1936 Summer Olympics,11,Yugoslavia,YUG,115,0,1,0,1
1936 Winter Olympics,32,Australia,AUS,1,0,0,0,0
1936 Winter Olympics,32,Austria,AUT,88,1,2,2,5
1936 Winter Olympics,32,Belgium,BEL,30,0,0,0,0
1936 Winter Olympics,32,Bulgaria,BUL,8,0,0,0,0
1936 Winter Olympics,32,Canada,CAN,31,0,15,0,15
1936 Winter Olympics,32,Spain,ESP,6,0,0,0,0
1936 Winter Olympics,32,Estonia,EST,5,0,0,0,0
1936 Winter Olympics,32,Finland,FIN,23,4,2,3,9
1936 Winter Olympics,32,France,FRA,33,0,0,1,1
1936 Winter Olympics,32,Great Britain,GBR,39,13,1,4,18
1936 Winter Olympics,32,Germany,GER,175,4,3,0,7
1936 Winter Olympics,32,Greece,GRE,1,0,0,0,0
1936 Winter Olympics,32,Hungary,HUN,30,0,0,2,2
1936 Winter Olympics,32,Italy,ITA,45,0,0,0,0
1936 Winter Olympics,32,Japan,JPN,35,0,0,0,0
1936 Winter Olympics,32,Latvia,LAT,27,0,0,0,0
1936 Winter Olympics,32,Liechtenstein,LIE,4,0,0,0,0
1936 Winter Olympics,32,Luxembourg,LUX,4,0,0,0,0
1936 Winter Olympics,32,Netherlands,NED,8,0,0,0,0
1936 Winter Olympics,32,Norway,NOR,32,7,8,3,18
1936 Winter Olympics,32,Poland,POL,24,0,0,0,0
1936 Winter Olympics,32,Romania,ROU,20,0,0,0,0
1936 Winter Olympics,32,Switzerland,SUI,42,4,6,0,10
1936 Winter Olympics,32,Sweden,SWE,37,2,2,6,10
1936 Winter Olympics,32,Czechoslovakia,TCH,59,0,0,0,0
1936 Winter Olympics,32,Türkiye,TUR,6,0,0,0,0
1936 Winter Olympics,32,United States,USA,57,2,0,16,18
1936 Winter Olympics,32,Yugoslavia,YUG,19,0,0,0,0
1948 Summer Olympics,12,Afghanistan,AFG,30,0,0,0,0
1948 Summer Olympics,12,Argentina,ARG,216,3,8,1,12
1948 Summer Olympics,12,Australia,AUS,76,2,10,5,17
1948 Summer Olympics,12,Austria,AUT,169,2,2,4,8
1948 Summer Olympics,12,Belgium,BEL,173,5,2,8,15
1948 Summer Olympics,12,Bermuda,BER,12,0,0,0,0
1948 Summer Olympics,12,Brazil,BRA,75,0,0,12,12
1948 Summer Olympics,12,Canada,CAN,126,0,2,8,10
1948 Summer Olympics,12,Chile,CHI,60,0,0,0,0
1948 Summer Olympics,12,People's Republic of China,CHN,38,0,0,0,0
1948 Summer Olympics,12,Colombia,COL,7,0,0,0,0
1948 Summer Olympics,12,Cuba,CUB,55,0,2,0,2
1948 Summer Olympics,12,Denmark,DEN,175,7,18,36,61
1948 Summer Olympics,12,Egypt,EGY,106,2,2,1,5
1948 Summer Olympics,12,Spain,ESP,82,0,3,0,3
1948 Summer Olympics,12,Finland,FIN,132,17,8,8,33
1948 Summer Olympics,12,France,FRA,343,26,26,27,79
1948 Summer Olympics,12,Great Britain,GBR,452,7,53,12,72
1948 Summer Olympics,12,Greece,GRE,62,0,0,0,0
1948 Summer Olympics,12,Guyana,GUY,4,0,0,0,0
1948 Summer Olympics,12,Hungary,HUN,152,15,27,22,64
1948 Summer Olympics,12,India,IND,88,20,0,0,20
1948 Summer Olympics,12,Islamic Republic of Iran,IRI,36,0,0,1,1
1948 Summer Olympics,12,Ireland,IRL,105,0,0,1,1
1948 Summer Olympics,12,Iraq,IRQ,11,0,0,0,0
1948 Summer Olympics,12,Iceland,ISL,23,0,0,0,0
1948 Summer Olympics,12,Italy,ITA,236,23,33,16,72
1948 Summer Olympics,12,Jamaica,JAM,14,1,2,0,3
1948 Summer Olympics,12,Republic of Korea,KOR,52,0,0,2,2
1948 Summer Olympics,12,Lebanon,LBN,8,0,0,0,0
1948 Summer Olympics,12,Liechtenstein,LIE,2,0,0,0,0
1948 Summer Olympics,12,Luxembourg,LUX,56,0,0,0,0
1948 Summer Olympics,12,Mexico,MEX,99,4,1,4,9
1948 Summer Olympics,12,Malta,MLT,1,0,0,0,0
1948 Summer Olympics,12,Monaco,MON,4,0,0,0,0
1948 Summer Olympics,12,Myanmar,MYA,5,0,0,0,0
1948 Summer Olympics,12,Netherlands,NED,172,9,2,45,56
1948 Summer Olympics,12,Norway,NOR,81,3,4,11,18
1948 Summer Olympics,12,New Zealand,NZL,7,0,0,0,0
1948 Summer Olympics,12,Pakistan,PAK,40,0,0,0,0
1948 Summer Olympics,12,Panama,PAN,1,0,0,2,2
1948 Summer Olympics,12,Peru,PER,43,1,0,0,1
1948 Summer Olympics,12,Philippines,PHI,26,0,0,0,0
1948 Summer Olympics,12,Poland,POL,40,1,0,1,2
1948 Summer Olympics,12,Portugal,POR,50,0,2,3,5
1948 Summer Olympics,12,Puerto Rico,PUR,9,0,0,1,1
1948 Summer Olympics,12,South Africa,RSA,35,2,2,2,6
1948 Summer Olympics,12,Singapore,SGP,1,0,0,0,0
1948 Summer Olympics,12,Sri Lanka,SRI,7,0,1,0,1
1948 Summer Olympics,12,Switzerland,SUI,190,5,24,6,35
1948 Summer Olympics,12,Sweden,SWE,191,36,15,32,83
1948 Summer Olympics,12,Syrian Arab Republic,SYR,1,0,0,0,0
1948 Summer Olympics,12,Czechoslovakia,TCH,91,14,3,3,20
1948 Summer Olympics,12,Trinidad and Tobago,TTO,5,0,1,0,1
1948 Summer Olympics,12,Türkiye,TUR,71,6,4,2,12
1948 Summer Olympics,12,Uruguay,URU,65,0,1,2,3
1948 Summer Olympics,12,United States,USA,339,98,30,35,163
1948 Summer Olympics,12,Venezuela,VEN,1,0,0,0,0
1948 Summer Olympics,12,Yugoslavia,YUG,101,0,23,0,23
1948 Winter Olympics,33,Argentina,ARG,9,0,0,0,0
1948 Winter Olympics,33,Austria,AUT,59,1,3,4,8
1948 Winter Olympics,33,Belgium,BEL,11,2,4,0,6
1948 Winter Olympics,33,Bulgaria,BUL,4,0,0,0,0
1948 Winter Olympics,33,Canada,CAN,34,18,0,2,20
1948 Winter Olympics,33,Chile,CHI,5,0,0,0,0
1948 Winter Olympics,33,Denmark,DEN,2,0,0,0,0
1948 Winter Olympics,33,Spain,ESP,6,0,0,0,0
1948 Winter Olympics,33,Finland,FIN,29,1,6,2,9
1948 Winter Olympics,33,France,FRA,40,2,1,2,5
1948 Winter Olympics,33,Great Britain,GBR,59,0,0,2,2
1948 Winter Olympics,33,Greece,GRE,1,0,0,0,0
1948 Winter Olympics,33,Hungary,HUN,22,0,2,0,2
1948 Winter Olympics,33,Iceland,ISL,4,0,0,0,0
1948 Winter Olympics,33,Italy,ITA,57,1,0,0,1
1948 Winter Olympics,33,Republic of Korea,KOR,3,0,0,0,0
1948 Winter Olympics,33,Lebanon,LBN,2,0,0,0,0
1948 Winter Olympics,33,Liechtenstein,LIE,10,0,0,0,0
1948 Winter Olympics,33,Netherlands,NED,4,0,0,0,0
1948 Winter Olympics,33,Norway,NOR,49,4,3,6,13
1948 Winter Olympics,33,Poland,POL,30,0,0,0,0
1948 Winter Olympics,33,Romania,ROU,11,0,0,0,0
1948 Winter Olympics,33,Switzerland,SUI,78,4,5,19,28
1948 Winter Olympics,33,Sweden,SWE,51,7,3,3,13
1948 Winter Olympics,33,Czechoslovakia,TCH,54,0,17,0,17
1948 Winter Olympics,33,Türkiye,TUR,5,0,0,0,0
1948 Winter Olympics,33,United States,USA,74,6,4,6,16
1948 Winter Olympics,33,Yugoslavia,YUG,17,0,0,0,0
1952 Summer Olympics,13,Netherlands Antilles,AHO,20,0,0,0,0
1952 Summer Olympics,13,Argentina,ARG,126,2,2,2,6
1952 Summer Olympics,13,Australia,AUS,88,7,2,11,20
1952 Summer Olympics,13,Austria,AUT,141,0,1,2,3
1952 Summer Olympics,13,The Bahamas,BAH,7,0,0,0,0
1952 Summer Olympics,13,Belgium,BEL,140,5,3,0,8
1952 Summer Olympics,13,Bermuda,BER,6,0,0,0,0
1952 Summer Olympics,13,Brazil,BRA,110,1,0,2,3
1952 Summer Olympics,13,Bulgaria,BUL,72,0,0,1,1
1952 Summer Olympics,13,Canada,CAN,120,1,3,0,4
1952 Summer Olympics,13,Chile,CHI,66,0,4,0,4
1952 Summer Olympics,13,People's Republic of China,CHN,1,0,0,0,0
1952 Summer Olympics,13,Cuba,CUB,29,0,0,0,0
1952 Summer Olympics,13,Denmark,DEN,153,3,1,5,9
1952 Summer Olympics,13,Egypt,EGY,119,0,0,1,1
1952 Summer Olympics,13,Spain,ESP,37,0,1,0,1
1952 Summer Olympics,13,Finland,FIN,322,8,3,29,40
1952 Summer Olympics,13,France,FRA,259,14,9,19,42
1952 Summer Olympics,13,Great Britain,GBR,282,3,2,33,38
1952 Summer Olympics,13,Germany,GER,241,0,18,30,48
1952 Summer Olympics,13,Ghana,GHA,9,0,0,0,0
1952 Summer Olympics,13,Greece,GRE,58,0,0,0,0
1952 Summer Olympics,13,Guatemala,GUA,24,0,0,0,0
1952 Summer Olympics,13,Guyana,GUY,1,0,0,0,0
1952 Summer Olympics,13,"Hong Kong, China",HKG,4,0,0,0,0
1952 Summer Olympics,13,Hungary,HUN,202,59,17,34,110
1952 Summer Olympics,13,Indonesia,INA,4,0,0,0,0
1952 Summer Olympics,13,India,IND,78,18,0,1,19
1952 Summer Olympics,13,Islamic Republic of Iran,IRI,25,0,3,4,7
1952 Summer Olympics,13,Ireland,IRL,43,0,1,0,1
1952 Summer Olympics,13,Iceland,ISL,12,0,0,0,0
1952 Summer Olympics,13,Israel,ISR,27,0,0,0,0
1952 Summer Olympics,13,Italy,ITA,251,17,22,15,54
1952 Summer Olympics,13,Jamaica,JAM,8,6,3,0,9
1952 Summer Olympics,13,Japan,JPN,72,1,12,2,15
1952 Summer Olympics,13,Republic of Korea,KOR,19,0,0,2,2
1952 Summer Olympics,13,Lebanon,LBN,9,0,1,1,2
1952 Summer Olympics,13,Liechtenstein,LIE,2,0,0,0,0
1952 Summer Olympics,13,Luxembourg,LUX,52,1,0,0,1
1952 Summer Olympics,13,Mexico,MEX,71,0,1,0,1
1952 Summer Olympics,13,Monaco,MON,8,0,0,0,0
1952 Summer Olympics,13,Myanmar,MYA,6,0,0,0,0
1952 Summer Olympics,13,Netherlands,NED,121,0,20,0,20
1952 Summer Olympics,13,Nigeria,NGR,9,0,0,0,0
1952 Summer Olympics,13,Norway,NOR,113,5,8,0,13
1952 Summer Olympics,13,New Zealand,NZL,14,1,0,2,3
1952 Summer Olympics,13,Pakistan,PAK,43,0,0,0,0
1952 Summer Olympics,13,Panama,PAN,5,0,0,0,0
1952 Summer Olympics,13,Philippines,PHI,25,0,0,0,0
1952 Summer Olympics,13,Poland,POL,153,1,2,1,4
1952 Summer Olympics,13,Portugal,POR,83,0,0,2,2
1952 Summer Olympics,13,Puerto Rico,PUR,21,0,0,0,0
1952 Summer Olympics,13,Romania,ROU,144,1,1,2,4
1952 Summer Olympics,13,South Africa,RSA,66,2,8,4,14
1952 Summer Olympics,13,Saar,SAA,36,0,0,0,0
1952 Summer Olympics,13,Singapore,SGP,5,0,0,0,0
1952 Summer Olympics,13,Sri Lanka,SRI,6,0,0,0,0
1952 Summer Olympics,13,Switzerland,SUI,163,2,19,12,33
1952 Summer Olympics,13,Sweden,SWE,236,23,24,31,78
1952 Summer Olympics,13,Czechoslovakia,TCH,101,11,4,10,25
1952 Summer Olympics,13,Thailand,THA,8,0,0,0,0
1952 Summer Olympics,13,Trinidad and Tobago,TTO,2,0,0,2,2
1952 Summer Olympics,13,Türkiye,TUR,62,2,0,1,3
1952 Summer Olympics,13,USSR,URS,317,36,65,19,120
1952 Summer Olympics,13,Uruguay,URU,33,0,0,14,14
1952 Summer Olympics,13,United States,USA,301,93,27,30,150
1952 Summer Olympics,13,Venezuela,VEN,39,0,0,1,1
1952 Summer Olympics,13,South Vietnam,VNM,9,0,0,0,0
1952 Summer Olympics,13,Yugoslavia,YUG,106,4,31,0,35
1952 Winter Olympics,34,Argentina,ARG,13,0,0,0,0
1952 Winter Olympics,34,Australia,AUS,9,0,0,0,0
1952 Winter Olympics,34,Austria,AUT,39,2,4,2,8
1952 Winter Olympics,34,Belgium,BEL,9,0,0,0,0
1952 Winter Olympics,34,Bulgaria,BUL,9,0,0,0,0
1952 Winter Olympics,34,Canada,CAN,39,16,0,1,17
1952 Winter Olympics,34,Chile,CHI,3,0,0,0,0
1952 Winter Olympics,34,Denmark,DEN,1,0,0,0,0
1952 Winter Olympics,34,Spain,ESP,4,0,0,0,0
1952 Winter Olympics,34,Finland,FIN,63,6,4,2,12
1952 Winter Olympics,34,France,FRA,26,0,0,1,1
1952 Winter Olympics,34,Great Britain,GBR,18,1,0,0,1
1952 Winter Olympics,34,Germany,GER,53,8,2,2,12
1952 Winter Olympics,34,Greece,GRE,3,0,0,0,0
1952 Winter Olympics,34,Hungary,HUN,12,0,0,2,2
1952 Winter Olympics,34,Iceland,ISL,11,0,0,0,0
1952 Winter Olympics,34,Italy,ITA,33,1,0,1,2
1952 Winter Olympics,34,Japan,JPN,13,0,0,0,0
1952 Winter Olympics,34,Lebanon,LBN,1,0,0,0,0
1952 Winter Olympics,34,Netherlands,NED,11,0,3,0,3
1952 Winter Olympics,34,Norway,NOR,85,7,6,6,19
1952 Winter Olympics,34,New Zealand,NZL,3,0,0,0,0
1952 Winter Olympics,34,Poland,POL,30,0,0,0,0
1952 Winter Olympics,34,Portugal,POR,1,0,0,0,0
1952 Winter Olympics,34,Romania,ROU,16,0,0,0,0
1952 Winter Olympics,34,Switzerland,SUI,55,0,0,6,6
1952 Winter Olympics,34,Sweden,SWE,79,0,0,23,23
1952 Winter Olympics,34,Czechoslovakia,TCH,22,0,0,0,0
1952 Winter Olympics,34,United States,USA,66,4,25,1,30
1952 Winter Olympics,34,Yugoslavia,YUG,6,0,0,0,0
1956 Equestrian Olympics,48,Argentina,ARG,7,0,0,0,0
1956 Equestrian Olympics,48,Australia,AUS,4,0,0,0,0
1956 Equestrian Olympics,48,Austria,AUT,5,0,0,0,0
1956 Equestrian Olympics,48,Belgium,BEL,3,0,0,0,0
1956 Equestrian Olympics,48,Brazil,BRA,3,0,0,0,0
1956 Equestrian Olympics,48,Bulgaria,BUL,4,0,0,0,0
1956 Equestrian Olympics,48,Cambodia,CAM,2,0,0,0,0
1956 Equestrian Olympics,48,Canada,CAN,4,0,0,3,3
1956 Equestrian Olympics,48,Denmark,DEN,6,0,1,0,1
1956 Equestrian Olympics,48,Egypt,EGY,3,0,0,0,0
1956 Equestrian Olympics,48,Spain,ESP,6,0,0,0,0
1956 Equestrian Olympics,48,Finland,FIN,7,0,0,0,0
1956 Equestrian Olympics,48,France,FRA,9,0,0,0,0
1956 Equestrian Olympics,48,Great Britain,GBR,8,3,0,4,7
1956 Equestrian Olympics,48,Germany,GER,9,4,7,1,12
1956 Equestrian Olympics,48,Hungary,HUN,3,0,0,0,0
1956 Equestrian Olympics,48,Ireland,IRL,6,0,0,0,0
1956 Equestrian Olympics,48,Italy,ITA,6,0,4,1,5
1956 Equestrian Olympics,48,Japan,JPN,2,0,0,0,0
1956 Equestrian Olympics,48,Netherlands,NED,1,0,0,0,0
1956 Equestrian Olympics,48,Norway,NOR,4,0,0,0,0
1956 Equestrian Olympics,48,Portugal,POR,7,0,0,0,0
1956 Equestrian Olympics,48,Romania,ROU,6,0,0,0,0
1956 Equestrian Olympics,48,Switzerland,SUI,9,0,0,3,3
1956 Equestrian Olympics,48,Sweden,SWE,9,5,0,0,5
1956 Equestrian Olympics,48,Türkiye,TUR,6,0,0,0,0
1956 Equestrian Olympics,48,USSR,URS,9,0,0,0,0
1956 Equestrian Olympics,48,United States,USA,8,0,0,0,0
1956 Equestrian Olympics,48,Venezuela,VEN,3,0,0,0,0
1956 Summer Olympics,14,Afghanistan,AFG,16,0,0,0,0
1956 Summer Olympics,14,Argentina,ARG,28,0,1,1,2
1956 Summer Olympics,14,Australia,AUS,371,34,14,26,74
1956 Summer Olympics,14,Austria,AUT,29,0,0,4,4
1956 Summer Olympics,14,The Bahamas,BAH,4,0,0,2,2
1956 Summer Olympics,14,Belgium,BEL,56,0,2,0,2
1956 Summer Olympics,14,Bermuda,BER,3,0,0,0,0
1956 Summer Olympics,14,Brazil,BRA,44,1,0,0,1
1956 Summer Olympics,14,Bulgaria,BUL,45,1,3,15,19
1956 Summer Olympics,14,Canada,CAN,92,5,9,2,16
1956 Summer Olympics,14,Chile,CHI,34,0,2,2,4
1956 Summer Olympics,14,Colombia,COL,28,0,0,0,0
1956 Summer Olympics,14,Cuba,CUB,16,0,0,0,0
1956 Summer Olympics,14,Denmark,DEN,31,1,3,1,5
1956 Summer Olympics,14,Ethiopia,ETH,13,0,0,0,0
1956 Summer Olympics,14,Fiji,FIJ,5,0,0,0,0
1956 Summer Olympics,14,Finland,FIN,64,3,1,22,26
1956 Summer Olympics,14,France,FRA,138,7,13,14,34
1956 Summer Olympics,14,Great Britain,GBR,196,5,20,22,47
1956 Summer Olympics,14,Germany,GER,167,5,13,27,45
1956 Summer Olympics,14,Greece,GRE,13,0,0,1,1
1956 Summer Olympics,14,Guyana,GUY,4,0,0,0,0
1956 Summer Olympics,14,"Hong Kong, China",HKG,2,0,0,0,0
1956 Summer Olympics,14,Hungary,HUN,111,31,20,14,65
1956 Summer Olympics,14,Indonesia,INA,29,0,0,0,0
1956 Summer Olympics,14,India,IND,61,18,0,0,18
1956 Summer Olympics,14,Islamic Republic of Iran,IRI,17,2,2,1,5
1956 Summer Olympics,14,Ireland,IRL,13,1,1,3,5
1956 Summer Olympics,14,Iceland,ISL,2,0,1,0,1
1956 Summer Olympics,14,Israel,ISR,3,0,0,0,0
1956 Summer Olympics,14,Italy,ITA,131,26,7,9,42
1956 Summer Olympics,14,Jamaica,JAM,6,0,0,0,0
1956 Summer Olympics,14,Japan,JPN,119,4,15,5,24
1956 Summer Olympics,14,Kenya,KEN,27,0,0,0,0
1956 Summer Olympics,14,Republic of Korea,KOR,35,0,1,1,2
1956 Summer Olympics,14,Liberia,LBR,5,0,0,0,0
1956 Summer Olympics,14,Luxembourg,LUX,11,0,0,0,0
1956 Summer Olympics,14,Malaya,MAL,33,0,0,0,0
1956 Summer Olympics,14,Mexico,MEX,24,1,0,1,2
1956 Summer Olympics,14,Myanmar,MYA,11,0,0,0,0
1956 Summer Olympics,14,North Borneo,NBO,2,0,0,0,0
1956 Summer Olympics,14,Nigeria,NGR,10,0,0,0,0
1956 Summer Olympics,14,Norway,NOR,18,1,0,2,3
1956 Summer Olympics,14,New Zealand,NZL,51,3,0,0,3
1956 Summer Olympics,14,Pakistan,PAK,61,0,18,0,18
1956 Summer Olympics,14,Peru,PER,8,0,0,0,0
1956 Summer Olympics,14,Philippines,PHI,39,0,0,0,0
1956 Summer Olympics,14,Poland,POL,64,1,9,9,19
1956 Summer Olympics,14,Portugal,POR,5,0,0,0,0
1956 Summer Olympics,14,Puerto Rico,PUR,13,0,0,0,0
1956 Summer Olympics,14,Romania,ROU,45,6,3,10,19
1956 Summer Olympics,14,South Africa,RSA,50,0,0,7,7
1956 Summer Olympics,14,Singapore,SGP,51,0,0,0,0
1956 Summer Olympics,14,Sri Lanka,SRI,3,0,0,0,0
1956 Summer Olympics,14,Sweden,SWE,90,9,14,6,29
1956 Summer Olympics,14,Czechoslovakia,TCH,64,1,5,1,7
1956 Summer Olympics,14,Thailand,THA,40,0,0,0,0
1956 Summer Olympics,14,Chinese Taipei,TPE,21,0,0,0,0
1956 Summer Olympics,14,Trinidad and Tobago,TTO,6,0,0,0,0
1956 Summer Olympics,14,Türkiye,TUR,13,3,2,2,7
1956 Summer Olympics,14,Uganda,UGA,3,0,0,0,0
1956 Summer Olympics,14,USSR,URS,280,70,48,59,177
1956 Summer Olympics,14,Uruguay,URU,21,0,0,12,12
1956 Summer Olympics,14,United States,USA,328,69,43,24,136
1956 Summer Olympics,14,Venezuela,VEN,20,0,0,0,0
1956 Summer Olympics,14,South Vietnam,VNM,6,0,0,0,0
1956 Summer Olympics,14,Yugoslavia,YUG,41,0,29,0,29
1956 Winter Olympics,35,Australia,AUS,10,0,0,0,0
1956 Winter Olympics,35,Austria,AUT,61,5,3,4,12
1956 Winter Olympics,35,Belgium,BEL,4,0,0,0,0
1956 Winter Olympics,35,Bolivia,BOL,1,0,0,0,0
1956 Winter Olympics,35,Bulgaria,BUL,7,0,0,0,0
1956 Winter Olympics,35,Canada,CAN,35,0,2,18,20
1956 Winter Olympics,35,Chile,CHI,3,0,0,0,0
1956 Winter Olympics,35,Spain,ESP,9,0,0,0,0
1956 Winter Olympics,35,Finland,FIN,31,5,6,1,12
1956 Winter Olympics,35,France,FRA,34,0,0,0,0
1956 Winter Olympics,35,Great Britain,GBR,41,0,0,0,0
1956 Winter Olympics,35,Germany,GER,63,1,0,1,2
1956 Winter Olympics,35,Greece,GRE,3,0,0,0,0
1956 Winter Olympics,35,Hungary,HUN,3,0,0,2,2
1956 Winter Olympics,35,Islamic Republic of Iran,IRI,3,0,0,0,0
1956 Winter Olympics,35,Iceland,ISL,8,0,0,0,0
1956 Winter Olympics,35,Italy,ITA,65,2,6,0,8
1956 Winter Olympics,35,Japan,JPN,10,0,1,0,1
1956 Winter Olympics,35,Republic of Korea,KOR,4,0,0,0,0
1956 Winter Olympics,35,Lebanon,LBN,3,0,0,0,0
1956 Winter Olympics,35,Liechtenstein,LIE,8,0,0,0,0
1956 Winter Olympics,35,Netherlands,NED,8,0,0,0,0
1956 Winter Olympics,35,Norway,NOR,46,2,1,1,4
1956 Winter Olympics,35,Poland,POL,51,0,0,1,1
1956 Winter Olympics,35,Romania,ROU,20,0,0,0,0
1956 Winter Olympics,35,Switzerland,SUI,59,6,2,2,10
1956 Winter Olympics,35,Sweden,SWE,59,2,4,9,15
1956 Winter Olympics,35,Czechoslovakia,TCH,42,0,0,0,0
1956 Winter Olympics,35,Türkiye,TUR,4,0,0,0,0
1956 Winter Olympics,35,USSR,URS,54,26,5,6,37
1956 Winter Olympics,35,United States,USA,68,2,20,5,27
1956 Winter Olympics,35,Yugoslavia,YUG,17,0,0,0,0
1960 Summer Olympics,15,Afghanistan,AFG,12,0,0,0,0
1960 Summer Olympics,15,Netherlands Antilles,AHO,5,0,0,0,0
1960 Summer Olympics,15,Argentina,ARG,98,0,3,1,4
1960 Summer Olympics,15,Australia,AUS,189,11,24,11,46
1960 Summer Olympics,15,Austria,AUT,114,1,2,0,3
1960 Summer Olympics,15,The Bahamas,BAH,14,0,0,0,0
1960 Summer Olympics,15,Belgium,BEL,107,0,2,2,4
1960 Summer Olympics,15,Bermuda,BER,9,0,0,0,0
1960 Summer Olympics,15,Brazil,BRA,76,0,0,13,13
1960 Summer Olympics,15,Bulgaria,BUL,109,1,3,3,7
1960 Summer Olympics,15,Canada,CAN,85,0,9,0,9
1960 Summer Olympics,15,Chile,CHI,9,0,0,0,0
1960 Summer Olympics,15,Colombia,COL,16,0,0,0,0
1960 Summer Olympics,15,Cuba,CUB,12,0,0,0,0
1960 Summer Olympics,15,Denmark,DEN,113,2,24,4,30
1960 Summer Olympics,15,Spain,ESP,148,0,0,18,18
1960 Summer Olympics,15,Ethiopia,ETH,11,1,0,0,1
1960 Summer Olympics,15,Fiji,FIJ,2,0,0,0,0
1960 Summer Olympics,15,Finland,FIN,117,1,1,4,6
1960 Summer Olympics,15,France,FRA,245,0,6,6,12
1960 Summer Olympics,15,Great Britain,GBR,263,2,11,17,30
1960 Summer Olympics,15,Germany,GER,306,36,37,24,97
1960 Summer Olympics,15,Ghana,GHA,15,0,1,0,1
1960 Summer Olympics,15,Greece,GRE,49,3,0,0,3
1960 Summer Olympics,15,Guyana,GUY,5,0,0,0,0
1960 Summer Olympics,15,Haiti,HAI,1,0,0,0,0
1960 Summer Olympics,15,"Hong Kong, China",HKG,4,0,0,0,0
1960 Summer Olympics,15,Hungary,HUN,190,13,16,40,69
1960 Summer Olympics,15,Indonesia,INA,25,0,0,0,0
1960 Summer Olympics,15,India,IND,64,0,21,0,21
1960 Summer Olympics,15,Islamic Republic of Iran,IRI,23,0,1,3,4
1960 Summer Olympics,15,Ireland,IRL,49,0,0,0,0
1960 Summer Olympics,15,Iraq,IRQ,21,0,0,1,1
1960 Summer Olympics,15,Iceland,ISL,9,0,0,0,0
1960 Summer Olympics,15,Israel,ISR,23,0,0,0,0
1960 Summer Olympics,15,Italy,ITA,290,37,19,34,90
1960 Summer Olympics,15,Japan,JPN,173,9,10,12,31
1960 Summer Olympics,15,Kenya,KEN,29,0,0,0,0
1960 Summer Olympics,15,Republic of Korea,KOR,36,0,0,0,0
1960 Summer Olympics,15,Lebanon,LBN,20,0,0,0,0
1960 Summer Olympics,15,Liberia,LBR,5,0,0,0,0
1960 Summer Olympics,15,Liechtenstein,LIE,5,0,0,0,0
1960 Summer Olympics,15,Luxembourg,LUX,53,0,0,0,0
1960 Summer Olympics,15,Malaya,MAL,9,0,0,0,0
1960 Summer Olympics,15,Morocco,MAR,47,0,1,0,1
1960 Summer Olympics,15,Mexico,MEX,70,0,0,1,1
1960 Summer Olympics,15,Malta,MLT,10,0,0,0,0
1960 Summer Olympics,15,Monaco,MON,11,0,0,0,0
1960 Summer Olympics,15,Myanmar,MYA,10,0,0,0,0
1960 Summer Olympics,15,Netherlands,NED,115,0,1,2,3
1960 Summer Olympics,15,Nigeria,NGR,13,0,0,0,0
1960 Summer Olympics,15,Norway,NOR,40,2,0,0,2
1960 Summer Olympics,15,New Zealand,NZL,37,2,0,1,3
1960 Summer Olympics,15,Pakistan,PAK,49,18,0,1,19
1960 Summer Olympics,15,Panama,PAN,7,0,0,0,0
1960 Summer Olympics,15,Peru,PER,31,0,0,0,0
1960 Summer Olympics,15,Philippines,PHI,41,0,0,0,0
1960 Summer Olympics,15,Poland,POL,211,4,11,17,32
1960 Summer Olympics,15,Portugal,POR,65,0,2,0,2
1960 Summer Olympics,15,Puerto Rico,PUR,28,0,0,0,0
1960 Summer Olympics,15,Rhodesia,RHO,12,0,0,0,0
1960 Summer Olympics,15,Romania,ROU,111,3,1,11,15
1960 Summer Olympics,15,South Africa,RSA,56,0,1,2,3
1960 Summer Olympics,15,Singapore,SGP,5,0,1,0,1
1960 Summer Olympics,15,San Marino,SMR,9,0,0,0,0
1960 Summer Olympics,15,Sri Lanka,SRI,5,0,0,0,0
1960 Summer Olympics,15,Sudan,SUD,10,0,0,0,0
1960 Summer Olympics,15,Switzerland,SUI,155,0,6,6,12
1960 Summer Olympics,15,Sweden,SWE,139,2,2,3,7
1960 Summer Olympics,15,Czechoslovakia,TCH,116,4,7,11,22
1960 Summer Olympics,15,Thailand,THA,20,0,0,0,0
1960 Summer Olympics,15,Chinese Taipei,TPE,34,0,1,0,1
1960 Summer Olympics,15,Tunisia,TUN,48,0,0,0,0
1960 Summer Olympics,15,Türkiye,TUR,53,7,2,0,9
1960 Summer Olympics,15,United Arab Republic,UAR,76,0,1,1,2
1960 Summer Olympics,15,Uganda,UGA,11,0,0,0,0
1960 Summer Olympics,15,USSR,URS,286,61,65,45,171
1960 Summer Olympics,15,Uruguay,URU,35,0,0,0,0
1960 Summer Olympics,15,United States,USA,295,85,23,21,129
1960 Summer Olympics,15,Venezuela,VEN,36,0,0,1,1
1960 Summer Olympics,15,South Vietnam,VNM,4,0,0,0,0
1960 Summer Olympics,15,West Indies Federation,WIF,14,0,0,7,7
1960 Summer Olympics,15,Yugoslavia,YUG,122,18,1,0,19
1960 Summer Olympics,15,Zimbabwe,ZIM,2,0,0,0,0
1960 Winter Olympics,36,Argentina,ARG,6,0,0,0,0
1960 Winter Olympics,36,Australia,AUS,30,0,0,0,0
1960 Winter Olympics,36,Austria,AUT,26,1,2,3,6
1960 Winter Olympics,36,Bulgaria,BUL,7,0,0,0,0
1960 Winter Olympics,36,Canada,CAN,44,3,17,1,21
1960 Winter Olympics,36,Chile,CHI,6,0,0,0,0
1960 Winter Olympics,36,Denmark,DEN,1,0,0,0,0
1960 Winter Olympics,36,Spain,ESP,5,0,0,0,0
1960 Winter Olympics,36,Finland,FIN,48,5,3,5,13
1960 Winter Olympics,36,France,FRA,26,1,0,2,3
1960 Winter Olympics,36,Great Britain,GBR,17,0,0,0,0
1960 Winter Olympics,36,Germany,GER,75,4,4,1,9
1960 Winter Olympics,36,Hungary,HUN,3,0,0,0,0
1960 Winter Olympics,36,Iceland,ISL,4,0,0,0,0
1960 Winter Olympics,36,Italy,ITA,28,0,0,1,1
1960 Winter Olympics,36,Japan,JPN,41,0,0,0,0
1960 Winter Olympics,36,Republic of Korea,KOR,7,0,0,0,0
1960 Winter Olympics,36,Lebanon,LBN,3,0,0,0,0
1960 Winter Olympics,36,Liechtenstein,LIE,3,0,0,0,0
1960 Winter Olympics,36,Netherlands,NED,7,0,1,1,2
1960 Winter Olympics,36,Norway,NOR,29,3,6,0,9
1960 Winter Olympics,36,New Zealand,NZL,4,0,0,0,0
1960 Winter Olympics,36,Poland,POL,13,0,1,1,2
1960 Winter Olympics,36,South Africa,RSA,4,0,0,0,0
1960 Winter Olympics,36,Switzerland,SUI,21,2,0,0,2
1960 Winter Olympics,36,Sweden,SWE,48,5,2,2,9
1960 Winter Olympics,36,Czechoslovakia,TCH,21,0,1,0,1
1960 Winter Olympics,36,Türkiye,TUR,2,0,0,0,0
1960 Winter Olympics,36,USSR,URS,62,7,7,28,42
1960 Winter Olympics,36,United States,USA,79,19,4,4,27
1964 Summer Olympics,16,Afghanistan,AFG,8,0,0,0,0
1964 Summer Olympics,16,Netherlands Antilles,AHO,4,0,0,0,0
1964 Summer Olympics,16,Algeria,ALG,1,0,0,0,0
1964 Summer Olympics,16,Argentina,ARG,109,0,1,0,1
1964 Summer Olympics,16,Australia,AUS,246,8,6,32,46
1964 Summer Olympics,16,Austria,AUT,57,0,0,0,0
1964 Summer Olympics,16,The Bahamas,BAH,11,2,0,0,2
1964 Summer Olympics,16,Belgium,BEL,62,2,0,1,3
1964 Summer Olympics,16,Bermuda,BER,4,0,0,0,0
1964 Summer Olympics,16,Bolivia,BOL,3,0,0,0,0
1964 Summer Olympics,16,Brazil,BRA,69,0,0,12,12
1964 Summer Olympics,16,Bulgaria,BUL,66,3,5,2,10
1964 Summer Olympics,16,Cambodia,CAM,13,0,0,0,0
1964 Summer Olympics,16,Canada,CAN,119,2,2,1,5
1964 Summer Olympics,16,Congo,CGO,2,0,0,0,0
1964 Summer Olympics,16,Chad,CHA,2,0,0,0,0
1964 Summer Olympics,16,Chile,CHI,14,0,0,0,0
1964 Summer Olympics,16,Côte d'Ivoire,CIV,9,0,0,0,0
1964 Summer Olympics,16,Cameroon,CMR,1,0,0,0,0
1964 Summer Olympics,16,Colombia,COL,21,0,0,0,0
1964 Summer Olympics,16,Costa Rica,CRC,2,0,0,0,0
1964 Summer Olympics,16,Cuba,CUB,27,0,1,0,1
1964 Summer Olympics,16,Denmark,DEN,60,7,1,4,12
1964 Summer Olympics,16,Dominican Republic,DOM,1,0,0,0,0
1964 Summer Olympics,16,Egypt,EGY,74,0,0,0,0
1964 Summer Olympics,16,Spain,ESP,55,0,0,0,0
1964 Summer Olympics,16,Ethiopia,ETH,12,1,0,0,1
1964 Summer Olympics,16,Finland,FIN,89,3,0,2,5
1964 Summer Olympics,16,France,FRA,142,1,13,19,33
1964 Summer Olympics,16,Great Britain,GBR,207,4,21,7,32
1964 Summer Olympics,16,Germany,GER,351,22,44,52,118
1964 Summer Olympics,16,Ghana,GHA,42,0,0,1,1
1964 Summer Olympics,16,Greece,GRE,19,0,0,0,0
1964 Summer Olympics,16,Guyana,GUY,1,0,0,0,0
1964 Summer Olympics,16,"Hong Kong, China",HKG,39,0,0,0,0
1964 Summer Olympics,16,Hungary,HUN,188,47,7,7,61
1964 Summer Olympics,16,India,IND,56,18,0,0,18
1964 Summer Olympics,16,Islamic Republic of Iran,IRI,63,0,0,2,2
1964 Summer Olympics,16,Ireland,IRL,25,0,0,1,1
1964 Summer Olympics,16,Iraq,IRQ,17,0,0,0,0
1964 Summer Olympics,16,Iceland,ISL,4,0,0,0,0
1964 Summer Olympics,16,Israel,ISR,10,0,0,0,0
1964 Summer Olympics,16,Italy,ITA,171,14,28,9,51
1964 Summer Olympics,16,Jamaica,JAM,21,0,0,0,0
1964 Summer Olympics,16,Japan,JPN,438,32,5,28,65
1964 Summer Olympics,16,Kenya,KEN,39,0,0,1,1
1964 Summer Olympics,16,Republic of Korea,KOR,159,0,2,1,3
1964 Summer Olympics,16,Lebanon,LBN,5,0,0,0,0
1964 Summer Olympics,16,Liberia,LBR,1,0,0,0,0
1964 Summer Olympics,16,Liechtenstein,LIE,2,0,0,0,0
1964 Summer Olympics,16,Luxembourg,LUX,12,0,0,0,0
1964 Summer Olympics,16,Madagascar,MAD,3,0,0,0,0
1964 Summer Olympics,16,Morocco,MAR,26,0,0,0,0
1964 Summer Olympics,16,Malaysia,MAS,65,0,0,0,0
1964 Summer Olympics,16,Mexico,MEX,98,0,0,1,1
1964 Summer Olympics,16,Mongolia,MGL,21,0,0,0,0
1964 Summer Olympics,16,Mali,MLI,2,0,0,0,0
1964 Summer Olympics,16,Monaco,MON,1,0,0,0,0
1964 Summer Olympics,16,Myanmar,MYA,11,0,0,0,0
1964 Summer Olympics,16,Netherlands,NED,125,5,10,16,31
1964 Summer Olympics,16,Nepal,NEP,6,0,0,0,0
1964 Summer Olympics,16,Nigeria,NGR,18,0,0,1,1
1964 Summer Olympics,16,Niger,NIG,1,0,0,0,0
1964 Summer Olympics,16,Norway,NOR,26,0,0,0,0
1964 Summer Olympics,16,New Zealand,NZL,68,4,0,2,6
1964 Summer Olympics,16,Pakistan,PAK,43,0,18,0,18
1964 Summer Olympics,16,Panama,PAN,12,0,0,0,0
1964 Summer Olympics,16,Peru,PER,31,0,0,0,0
1964 Summer Olympics,16,Philippines,PHI,48,0,1,0,1
1964 Summer Olympics,16,Poland,POL,143,12,16,26,54
1964 Summer Olympics,16,Portugal,POR,20,0,0,0,0
1964 Summer Olympics,16,Puerto Rico,PUR,32,0,0,0,0
1964 Summer Olympics,16,Romania,ROU,153,2,4,10,16
1964 Summer Olympics,16,Senegal,SEN,12,0,0,0,0
1964 Summer Olympics,16,Sri Lanka,SRI,6,0,0,0,0
1964 Summer Olympics,16,Switzerland,SUI,67,1,4,1,6
1964 Summer Olympics,16,Sweden,SWE,97,3,4,8,15
1964 Summer Olympics,16,United Republic of Tanzania,TAN,4,0,0,0,0
1964 Summer Olympics,16,Czechoslovakia,TCH,105,5,38,12,55
1964 Summer Olympics,16,Thailand,THA,58,0,0,0,0
1964 Summer Olympics,16,Chinese Taipei,TPE,41,0,0,0,0
1964 Summer Olympics,16,Trinidad and Tobago,TTO,13,0,1,7,8
1964 Summer Olympics,16,Tunisia,TUN,10,0,1,1,2
1964 Summer Olympics,16,Türkiye,TUR,23,2,3,1,6
1964 Summer Olympics,16,Uganda,UGA,15,0,0,0,0
1964 Summer Olympics,16,USSR,URS,321,61,63,51,175
1964 Summer Olympics,16,Uruguay,URU,23,0,0,1,1
1964 Summer Olympics,16,United States,USA,369,99,39,37,175
1964 Summer Olympics,16,Venezuela,VEN,17,0,0,0,0
1964 Summer Olympics,16,South Vietnam,VNM,16,0,0,0,0
1964 Summer Olympics,16,Yugoslavia,YUG,77,2,11,2,15
1964 Summer Olympics,16,Zambia,ZAM,12,0,0,0,0
1964 Summer Olympics,16,Zimbabwe,ZIM,30,0,0,0,0
1964 Winter Olympics,37,Argentina,ARG,12,0,0,0,0
1964 Winter Olympics,37,Australia,AUS,5,0,0,0,0
1964 Winter Olympics,37,Austria,AUT,111,5,9,3,17
1964 Winter Olympics,37,Belgium,BEL,8,0,0,0,0
1964 Winter Olympics,37,Bulgaria,BUL,7,0,0,0,0
1964 Winter Olympics,37,Canada,CAN,59,4,2,1,7
1964 Winter Olympics,37,Chile,CHI,5,0,0,0,0
1964 Winter Olympics,37,Denmark,DEN,2,0,0,0,0
1964 Winter Olympics,37,Spain,ESP,6,0,0,0,0
1964 Winter Olympics,37,Finland,FIN,52,3,7,5,15
1964 Winter Olympics,37,France,FRA,24,3,4,0,7
1964 Winter Olympics,37,Great Britain,GBR,36,2,0,0,2
1964 Winter Olympics,37,Germany,GER,119,3,4,3,10
1964 Winter Olympics,37,Greece,GRE,3,0,0,0,0
1964 Winter Olympics,37,Hungary,HUN,28,0,0,0,0
1964 Winter Olympics,37,India,IND,1,0,0,0,0
1964 Winter Olympics,37,Islamic Republic of Iran,IRI,4,0,0,0,0
1964 Winter Olympics,37,Iceland,ISL,5,0,0,0,0
1964 Winter Olympics,37,Italy,ITA,85,0,2,8,10
1964 Winter Olympics,37,Japan,JPN,47,0,0,0,0
1964 Winter Olympics,37,Republic of Korea,KOR,7,0,0,0,0
1964 Winter Olympics,37,Lebanon,LBN,4,0,0,0,0
1964 Winter Olympics,37,Liechtenstein,LIE,6,0,0,0,0
1964 Winter Olympics,37,Mongolia,MGL,13,0,0,0,0
1964 Winter Olympics,37,Netherlands,NED,6,1,1,0,2
1964 Winter Olympics,37,Norway,NOR,58,3,6,6,15
1964 Winter Olympics,37,Poland,POL,51,0,0,0,0
1964 Winter Olympics,37,Democratic People's Republic of Korea,PRK,15,0,1,0,1
1964 Winter Olympics,37,Romania,ROU,27,0,0,0,0
1964 Winter Olympics,37,Switzerland,SUI,90,0,0,0,0
1964 Winter Olympics,37,Sweden,SWE,57,6,21,1,28
1964 Winter Olympics,37,Czechoslovakia,TCH,46,0,0,17,17
1964 Winter Olympics,37,Türkiye,TUR,5,0,0,0,0
1964 Winter Olympics,37,USSR,URS,71,30,8,9,47
1964 Winter Olympics,37,United States,USA,90,1,2,5,8
1964 Winter Olympics,37,Yugoslavia,YUG,31,0,0,0,0
1968 Summer Olympics,17,Afghanistan,AFG,5,0,0,0,0
1968 Summer Olympics,17,Netherlands Antilles,AHO,5,0,0,0,0
1968 Summer Olympics,17,Algeria,ALG,3,0,0,0,0
1968 Summer Olympics,17,Argentina,ARG,95,0,0,2,2
1968 Summer Olympics,17,Australia,AUS,130,5,37,11,53
1968 Summer Olympics,17,Austria,AUT,43,0,2,3,5
1968 Summer Olympics,17,The Bahamas,BAH,17,0,0,0,0
1968 Summer Olympics,17,Barbados,BAR,10,0,0,0,0
1968 Summer Olympics,17,Belgium,BEL,86,0,1,2,3
1968 Summer Olympics,17,Bermuda,BER,6,0,0,0,0
1968 Summer Olympics,17,Belize,BIZ,7,0,0,0,0
1968 Summer Olympics,17,Bolivia,BOL,4,0,0,0,0
1968 Summer Olympics,17,Brazil,BRA,85,0,1,3,4
1968 Summer Olympics,17,Bulgaria,BUL,114,2,22,3,27
1968 Summer Olympics,17,Central African Republic,CAF,1,0,0,0,0
1968 Summer Olympics,17,Canada,CAN,139,3,3,4,10
1968 Summer Olympics,17,Chad,CHA,4,0,0,0,0
1968 Summer Olympics,17,Chile,CHI,21,0,0,0,0
1968 Summer Olympics,17,Côte d'Ivoire,CIV,12,0,0,0,0
1968 Summer Olympics,17,Cameroon,CMR,6,0,1,0,1
1968 Summer Olympics,17,Democratic Republic of the Congo,COD,5,0,0,0,0
1968 Summer Olympics,17,Colombia,COL,46,0,0,0,0
1968 Summer Olympics,17,Costa Rica,CRC,20,0,0,0,0
1968 Summer Olympics,17,Cuba,CUB,120,0,15,0,15
1968 Summer Olympics,17,Denmark,DEN,66,5,6,6,17
1968 Summer Olympics,17,Dominican Republic,DOM,19,0,0,0,0
1968 Summer Olympics,17,Ecuador,ECU,21,0,0,0,0
1968 Summer Olympics,17,Egypt,EGY,31,0,0,0,0
1968 Summer Olympics,17,El Salvador,ESA,61,0,0,0,0
1968 Summer Olympics,17,Spain,ESP,143,0,0,0,0
1968 Summer Olympics,17,Ethiopia,ETH,20,1,1,0,2
1968 Summer Olympics,17,Fiji,FIJ,1,0,0,0,0
1968 Summer Olympics,17,Finland,FIN,67,1,2,1,4
1968 Summer Olympics,17,France,FRA,219,12,5,12,29
1968 Summer Olympics,17,FRG,FRG,284,17,16,20,53
1968 Summer Olympics,17,Great Britain,GBR,229,9,5,5,19
1968 Summer Olympics,17,German Dem. Republic,GDR,236,13,20,19,52
1968 Summer Olympics,17,Ghana,GHA,37,0,0,0,0
1968 Summer Olympics,17,Greece,GRE,46,0,0,1,1
1968 Summer Olympics,17,Guatemala,GUA,48,0,0,0,0
1968 Summer Olympics,17,Guinea,GUI,19,0,0,0,0
1968 Summer Olympics,17,Guyana,GUY,5,0,0,0,0
1968 Summer Olympics,17,"Hong Kong, China",HKG,11,0,0,0,0
1968 Summer Olympics,17,Honduras,HON,6,0,0,0,0
1968 Summer Olympics,17,Hungary,HUN,177,34,20,29,83
1968 Summer Olympics,17,Indonesia,INA,6,0,0,0,0
1968 Summer Olympics,17,India,IND,28,0,0,17,17
1968 Summer Olympics,17,Islamic Republic of Iran,IRI,14,2,1,2,5
1968 Summer Olympics,17,Ireland,IRL,31,0,0,0,0
1968 Summer Olympics,17,Iraq,IRQ,3,0,0,0,0
1968 Summer Olympics,17,Iceland,ISL,8,0,0,0,0
1968 Summer Olympics,17,Israel,ISR,31,0,0,0,0
1968 Summer Olympics,17,United States Virgin Islands,ISV,6,0,0,0,0
1968 Summer Olympics,17,Italy,ITA,183,5,12,20,37
1968 Summer Olympics,17,Jamaica,JAM,31,0,1,0,1
1968 Summer Olympics,17,Japan,JPN,183,16,29,24,69
1968 Summer Olympics,17,Kenya,KEN,41,3,8,2,13
1968 Summer Olympics,17,Republic of Korea,KOR,55,0,1,1,2
1968 Summer Olympics,17,Kuwait,KUW,2,0,0,0,0
1968 Summer Olympics,17,Libya,LBA,1,0,0,0,0
1968 Summer Olympics,17,Lebanon,LBN,11,0,0,0,0
1968 Summer Olympics,17,Liechtenstein,LIE,2,0,0,0,0
1968 Summer Olympics,17,Luxembourg,LUX,5,0,0,0,0
1968 Summer Olympics,17,Madagascar,MAD,4,0,0,0,0
1968 Summer Olympics,17,Morocco,MAR,26,0,0,0,0
1968 Summer Olympics,17,Malaysia,MAS,32,0,0,0,0
1968 Summer Olympics,17,Mexico,MEX,311,3,3,3,9
1968 Summer Olympics,17,Mongolia,MGL,16,0,1,3,4
1968 Summer Olympics,17,Mali,MLI,2,0,0,0,0
1968 Summer Olympics,17,Malta,MLT,1,0,0,0,0
1968 Summer Olympics,17,Monaco,MON,2,0,0,0,0
1968 Summer Olympics,17,Myanmar,MYA,4,0,0,0,0
1968 Summer Olympics,17,Nicaragua,NCA,11,0,0,0,0
1968 Summer Olympics,17,Netherlands,NED,111,6,7,1,14
1968 Summer Olympics,17,Nigeria,NGR,43,0,0,0,0
1968 Summer Olympics,17,Niger,NIG,2,0,0,0,0
1968 Summer Olympics,17,Norway,NOR,46,4,2,0,6
1968 Summer Olympics,17,New Zealand,NZL,55,5,0,2,7
1968 Summer Olympics,17,Pakistan,PAK,20,18,0,0,18
1968 Summer Olympics,17,Panama,PAN,16,0,0,0,0
1968 Summer Olympics,17,Paraguay,PAR,1,0,0,0,0
1968 Summer Olympics,17,Peru,PER,30,0,0,0,0
1968 Summer Olympics,17,Philippines,PHI,52,0,0,0,0
1968 Summer Olympics,17,Poland,POL,179,5,2,30,37
1968 Summer Olympics,17,Portugal,POR,20,0,0,0,0
1968 Summer Olympics,17,Puerto Rico,PUR,63,0,0,0,0
1968 Summer Olympics,17,Romania,ROU,82,5,9,9,23
1968 Summer Olympics,17,Senegal,SEN,22,0,0,0,0
1968 Summer Olympics,17,Singapore,SGP,5,0,0,0,0
1968 Summer Olympics,17,Sierra Leone,SLE,3,0,0,0,0
1968 Summer Olympics,17,San Marino,SMR,4,0,0,0,0
1968 Summer Olympics,17,Sri Lanka,SRI,3,0,0,0,0
1968 Summer Olympics,17,Sudan,SUD,5,0,0,0,0
1968 Summer Olympics,17,Switzerland,SUI,86,0,3,10,13
1968 Summer Olympics,17,Suriname,SUR,1,0,0,0,0
1968 Summer Olympics,17,Sweden,SWE,106,4,4,1,9
1968 Summer Olympics,17,Syrian Arab Republic,SYR,2,0,0,0,0
1968 Summer Olympics,17,United Republic of Tanzania,TAN,4,0,0,0,0
1968 Summer Olympics,17,Czechoslovakia,TCH,121,7,7,15,29
1968 Summer Olympics,17,Thailand,THA,42,0,0,0,0
1968 Summer Olympics,17,Chinese Taipei,TPE,43,0,0,1,1
1968 Summer Olympics,17,Trinidad and Tobago,TTO,20,0,0,0,0
1968 Summer Olympics,17,Tunisia,TUN,7,1,0,1,2
1968 Summer Olympics,17,Türkiye,TUR,29,2,0,0,2
1968 Summer Olympics,17,Uganda,UGA,11,0,1,1,2
1968 Summer Olympics,17,USSR,URS,324,66,63,66,195
1968 Summer Olympics,17,Uruguay,URU,33,0,0,0,0
1968 Summer Olympics,17,United States,USA,381,105,32,35,172
1968 Summer Olympics,17,Venezuela,VEN,26,1,0,0,1
1968 Summer Olympics,17,South Vietnam,VNM,11,0,0,0,0
1968 Summer Olympics,17,Yugoslavia,YUG,69,13,14,2,29
1968 Summer Olympics,17,Zambia,ZAM,7,0,0,0,0
1968 Winter Olympics,38,Argentina,ARG,7,0,0,0,0
1968 Winter Olympics,38,Australia,AUS,3,0,0,0,0
1968 Winter Olympics,38,Austria,AUT,76,3,8,4,15
1968 Winter Olympics,38,Bulgaria,BUL,6,0,0,0,0
1968 Winter Olympics,38,Canada,CAN,72,1,1,18,20
1968 Winter Olympics,38,Chile,CHI,5,0,0,0,0
1968 Winter Olympics,38,Denmark,DEN,3,0,0,0,0
1968 Winter Olympics,38,Spain,ESP,20,0,0,0,0
1968 Winter Olympics,38,Finland,FIN,53,1,2,5,8
1968 Winter Olympics,38,France,FRA,80,4,3,2,9
1968 Winter Olympics,38,FRG,FRG,89,2,3,5,10
1968 Winter Olympics,38,Great Britain,GBR,44,0,0,0,0
1968 Winter Olympics,38,German Dem. Republic,GDR,57,2,2,2,6
1968 Winter Olympics,38,Greece,GRE,3,0,0,0,0
1968 Winter Olympics,38,Hungary,HUN,12,0,0,0,0
1968 Winter Olympics,38,India,IND,1,0,0,0,0
1968 Winter Olympics,38,Islamic Republic of Iran,IRI,4,0,0,0,0
1968 Winter Olympics,38,Iceland,ISL,4,0,0,0,0
1968 Winter Olympics,38,Italy,ITA,47,8,0,0,8
1968 Winter Olympics,38,Japan,JPN,61,0,0,0,0
1968 Winter Olympics,38,Republic of Korea,KOR,8,0,0,0,0
1968 Winter Olympics,38,Lebanon,LBN,3,0,0,0,0
1968 Winter Olympics,38,Liechtenstein,LIE,9,0,0,0,0
1968 Winter Olympics,38,Morocco,MAR,5,0,0,0,0
1968 Winter Olympics,38,Mongolia,MGL,7,0,0,0,0
1968 Winter Olympics,38,Netherlands,NED,9,3,3,3,9
1968 Winter Olympics,38,Norway,NOR,66,11,9,2,22
1968 Winter Olympics,38,New Zealand,NZL,6,0,0,0,0
1968 Winter Olympics,38,Poland,POL,31,0,0,0,0
1968 Winter Olympics,38,Romania,ROU,30,0,0,2,2
1968 Winter Olympics,38,Switzerland,SUI,34,0,2,7,9
1968 Winter Olympics,38,Sweden,SWE,68,3,7,6,16
1968 Winter Olympics,38,Czechoslovakia,TCH,50,1,19,1,21
1968 Winter Olympics,38,Türkiye,TUR,11,0,0,0,0
1968 Winter Olympics,38,USSR,URS,78,26,6,5,37
1968 Winter Olympics,38,United States,USA,103,1,5,1,7
1968 Winter Olympics,38,Yugoslavia,YUG,30,0,0,0,0
1972 Summer Olympics,18,Afghanistan,AFG,8,0,0,0,0
1972 Summer Olympics,18,Netherlands Antilles,AHO,2,0,0,0,0
1972 Summer Olympics,18,Albania,ALB,5,0,0,0,0
1972 Summer Olympics,18,Algeria,ALG,5,0,0,0,0
1972 Summer Olympics,18,Argentina,ARG,97,0,1,0,1
1972 Summer Olympics,18,Australia,AUS,172,11,7,2,20
1972 Summer Olympics,18,Austria,AUT,115,0,1,2,3
1972 Summer Olympics,18,The Bahamas,BAH,20,0,0,0,0
1972 Summer Olympics,18,Barbados,BAR,13,0,0,0,0
1972 Summer Olympics,18,Belgium,BEL,90,0,2,0,2
1972 Summer Olympics,18,Benin,BEN,4,0,0,0,0
1972 Summer Olympics,18,Bermuda,BER,9,0,0,0,0
1972 Summer Olympics,18,Belize,BIZ,1,0,0,0,0
1972 Summer Olympics,18,Bolivia,BOL,11,0,0,0,0
1972 Summer Olympics,18,Brazil,BRA,85,0,0,2,2
1972 Summer Olympics,18,Bulgaria,BUL,140,6,10,6,22
1972 Summer Olympics,18,Burkina Faso,BUR,1,0,0,0,0
1972 Summer Olympics,18,Cambodia,CAM,10,0,0,0,0
1972 Summer Olympics,18,Canada,CAN,214,0,2,11,13
1972 Summer Olympics,18,Congo,CGO,7,0,0,0,0
1972 Summer Olympics,18,Chad,CHA,4,0,0,0,0
1972 Summer Olympics,18,Chile,CHI,11,0,0,0,0
1972 Summer Olympics,18,Côte d'Ivoire,CIV,13,0,0,0,0
1972 Summer Olympics,18,Cameroon,CMR,11,0,0,0,0
1972 Summer Olympics,18,Colombia,COL,62,0,1,2,3
1972 Summer Olympics,18,Costa Rica,CRC,3,0,0,0,0
1972 Summer Olympics,18,Cuba,CUB,142,3,1,18,22
1972 Summer Olympics,18,Denmark,DEN,131,1,0,0,1
1972 Summer Olympics,18,Dominican Republic,DOM,5,0,0,0,0
1972 Summer Olympics,18,Ecuador,ECU,5,0,0,0,0
1972 Summer Olympics,18,Egypt,EGY,25,0,0,0,0
1972 Summer Olympics,18,El Salvador,ESA,11,0,0,0,0
1972 Summer Olympics,18,Spain,ESP,125,0,0,1,1
1972 Summer Olympics,18,Ethiopia,ETH,34,0,0,2,2
1972 Summer Olympics,18,Fiji,FIJ,2,0,0,0,0
1972 Summer Olympics,18,Finland,FIN,101,3,1,6,10
1972 Summer Olympics,18,France,FRA,237,2,5,17,24
1972 Summer Olympics,18,FRG,FRG,437,46,19,45,110
1972 Summer Olympics,18,Gabon,GAB,2,0,0,0,0
1972 Summer Olympics,18,Great Britain,GBR,296,8,11,12,31
1972 Summer Olympics,18,German Dem. Republic,GDR,304,32,69,59,160
1972 Summer Olympics,18,Ghana,GHA,38,0,0,1,1
1972 Summer Olympics,18,Greece,GRE,60,0,2,0,2
1972 Summer Olympics,18,Guatemala,GUA,8,0,0,0,0
1972 Summer Olympics,18,Guyana,GUY,3,0,0,0,0
1972 Summer Olympics,18,Haiti,HAI,7,0,0,0,0
1972 Summer Olympics,18,"Hong Kong, China",HKG,10,0,0,0,0
1972 Summer Olympics,18,Hungary,HUN,238,10,48,25,83
1972 Summer Olympics,18,Indonesia,INA,10,0,0,0,0
1972 Summer Olympics,18,India,IND,47,0,0,18,18
1972 Summer Olympics,18,Islamic Republic of Iran,IRI,50,0,2,1,3
1972 Summer Olympics,18,Ireland,IRL,60,0,0,0,0
1972 Summer Olympics,18,Iceland,ISL,26,0,0,0,0
1972 Summer Olympics,18,Israel,ISR,14,0,0,0,0
1972 Summer Olympics,18,United States Virgin Islands,ISV,16,0,0,0,0
1972 Summer Olympics,18,Italy,ITA,235,9,3,13,25
1972 Summer Olympics,18,Jamaica,JAM,40,0,0,1,1
1972 Summer Olympics,18,Japan,JPN,192,29,19,8,56
1972 Summer Olympics,18,Kenya,KEN,57,7,3,4,14
1972 Summer Olympics,18,Republic of Korea,KOR,46,0,1,0,1
1972 Summer Olympics,18,Kingdom of Saudi Arabia,KSA,12,0,0,0,0
1972 Summer Olympics,18,Kuwait,KUW,6,0,0,0,0
1972 Summer Olympics,18,Lebanon,LBN,20,0,1,0,1
1972 Summer Olympics,18,Liberia,LBR,6,0,0,0,0
1972 Summer Olympics,18,Lesotho,LES,1,0,0,0,0
1972 Summer Olympics,18,Liechtenstein,LIE,6,0,0,0,0
1972 Summer Olympics,18,Luxembourg,LUX,12,0,0,0,0
1972 Summer Olympics,18,Madagascar,MAD,12,0,0,0,0
1972 Summer Olympics,18,Morocco,MAR,38,0,0,0,0
1972 Summer Olympics,18,Malaysia,MAS,57,0,0,0,0
1972 Summer Olympics,18,Malawi,MAW,16,0,0,0,0
1972 Summer Olympics,18,Mexico,MEX,177,0,1,0,1
1972 Summer Olympics,18,Mongolia,MGL,39,0,1,0,1
1972 Summer Olympics,18,Mali,MLI,3,0,0,0,0
1972 Summer Olympics,18,Malta,MLT,5,0,0,0,0
1972 Summer Olympics,18,Monaco,MON,5,0,0,0,0
1972 Summer Olympics,18,Myanmar,MYA,24,0,0,0,0
1972 Summer Olympics,18,Nicaragua,NCA,9,0,0,0,0
1972 Summer Olympics,18,Netherlands,NED,128,3,1,2,6
1972 Summer Olympics,18,Nepal,NEP,2,0,0,0,0
1972 Summer Olympics,18,Nigeria,NGR,28,0,0,1,1
1972 Summer Olympics,18,Niger,NIG,4,0,0,1,1
1972 Summer Olympics,18,Norway,NOR,116,2,2,4,8
1972 Summer Olympics,18,New Zealand,NZL,91,9,4,1,14
1972 Summer Olympics,18,Pakistan,PAK,28,0,18,0,18
1972 Summer Olympics,18,Panama,PAN,7,0,0,0,0
1972 Summer Olympics,18,Paraguay,PAR,4,0,0,0,0
1972 Summer Olympics,18,Peru,PER,20,0,0,0,0
1972 Summer Olympics,18,Philippines,PHI,54,0,0,0,0
1972 Summer Olympics,18,Poland,POL,304,29,8,11,48
1972 Summer Olympics,18,Portugal,POR,29,0,0,0,0
1972 Summer Olympics,18,Democratic People's Republic of Korea,PRK,39,1,1,14,16
1972 Summer Olympics,18,Puerto Rico,PUR,53,0,0,0,0
1972 Summer Olympics,18,Romania,ROU,161,3,10,29,42
1972 Summer Olympics,18,Senegal,SEN,41,0,0,0,0
1972 Summer Olympics,18,Singapore,SGP,7,0,0,0,0
1972 Summer Olympics,18,San Marino,SMR,7,0,0,0,0
1972 Summer Olympics,18,Somalia,SOM,4,0,0,0,0
1972 Summer Olympics,18,Sri Lanka,SRI,4,0,0,0,0
1972 Summer Olympics,18,Sudan,SUD,32,0,0,0,0
1972 Summer Olympics,18,Switzerland,SUI,153,0,8,0,8
1972 Summer Olympics,18,Suriname,SUR,2,0,0,0,0
1972 Summer Olympics,18,Sweden,SWE,137,4,10,8,22
1972 Summer Olympics,18,Eswatini,SWZ,2,0,0,0,0
1972 Summer Olympics,18,Syrian Arab Republic,SYR,5,0,0,0,0
1972 Summer Olympics,18,United Republic of Tanzania,TAN,16,0,0,0,0
1972 Summer Olympics,18,Czechoslovakia,TCH,182,2,21,6,29
1972 Summer Olympics,18,Thailand,THA,36,0,0,0,0
1972 Summer Olympics,18,Togo,TOG,8,0,0,0,0
1972 Summer Olympics,18,Chinese Taipei,TPE,21,0,0,0,0
1972 Summer Olympics,18,Trinidad and Tobago,TTO,20,0,0,0,0
1972 Summer Olympics,18,Tunisia,TUN,35,0,1,0,1
1972 Summer Olympics,18,Türkiye,TUR,44,0,1,0,1
1972 Summer Olympics,18,Uganda,UGA,34,1,1,0,2
1972 Summer Olympics,18,USSR,URS,375,107,49,60,216
1972 Summer Olympics,18,Uruguay,URU,13,0,0,0,0
1972 Summer Olympics,18,United States,USA,410,72,61,43,176
1972 Summer Olympics,18,Venezuela,VEN,26,0,0,0,0
1972 Summer Olympics,18,South Vietnam,VNM,2,0,0,0,0
1972 Summer Olympics,18,Yugoslavia,YUG,130,17,1,2,20
1972 Summer Olympics,18,Zambia,ZAM,11,0,0,0,0
1972 Winter Olympics,39,Argentina,ARG,2,0,0,0,0
1972 Winter Olympics,39,Australia,AUS,4,0,0,0,0
1972 Winter Olympics,39,Austria,AUT,40,1,2,2,5
1972 Winter Olympics,39,Belgium,BEL,1,0,0,0,0
1972 Winter Olympics,39,Bulgaria,BUL,4,0,0,0,0
1972 Winter Olympics,39,Canada,CAN,49,0,1,0,1
1972 Winter Olympics,39,Spain,ESP,3,1,0,0,1
1972 Winter Olympics,39,Finland,FIN,51,0,9,1,10
1972 Winter Olympics,39,France,FRA,41,0,1,2,3
1972 Winter Olympics,39,FRG,FRG,78,4,2,4,10
1972 Winter Olympics,39,Great Britain,GBR,37,0,0,0,0
1972 Winter Olympics,39,German Dem. Republic,GDR,42,5,3,12,20
1972 Winter Olympics,39,Greece,GRE,3,0,0,0,0
1972 Winter Olympics,39,Hungary,HUN,1,0,0,0,0
1972 Winter Olympics,39,Islamic Republic of Iran,IRI,4,0,0,0,0
1972 Winter Olympics,39,Italy,ITA,44,3,5,1,9
1972 Winter Olympics,39,Japan,JPN,86,1,1,1,3
1972 Winter Olympics,39,Republic of Korea,KOR,5,0,0,0,0
1972 Winter Olympics,39,Lebanon,LBN,1,0,0,0,0
1972 Winter Olympics,39,Liechtenstein,LIE,4,0,0,0,0
1972 Winter Olympics,39,Mongolia,MGL,4,0,0,0,0
1972 Winter Olympics,39,Netherlands,NED,11,4,3,2,9
1972 Winter Olympics,39,Norway,NOR,69,2,8,7,17
1972 Winter Olympics,39,New Zealand,NZL,2,0,0,0,0
1972 Winter Olympics,39,Philippines,PHI,2,0,0,0,0
1972 Winter Olympics,39,Poland,POL,47,1,0,0,1
1972 Winter Olympics,39,Democratic People's Republic of Korea,PRK,6,0,0,0,0
1972 Winter Olympics,39,Romania,ROU,13,0,0,0,0
1972 Winter Olympics,39,Switzerland,SUI,54,7,3,7,17
1972 Winter Olympics,39,Sweden,SWE,58,1,1,2,4
1972 Winter Olympics,39,Czechoslovakia,TCH,44,1,0,22,23
1972 Winter Olympics,39,Chinese Taipei,TPE,5,0,0,0,0
1972 Winter Olympics,39,USSR,URS,76,36,6,3,45
1972 Winter Olympics,39,United States,USA,107,3,21,3,27
1972 Winter Olympics,39,Yugoslavia,YUG,26,0,0,0,0
1976 Summer Olympics,19,Netherlands Antilles,AHO,4,0,0,0,0
1976 Summer Olympics,19,Andorra,AND,3,0,0,0,0
1976 Summer Olympics,19,Antigua and Barbuda,ANT,10,0,0,0,0
1976 Summer Olympics,19,Argentina,ARG,69,0,0,0,0
1976 Summer Olympics,19,Australia,AUS,182,0,16,8,24
1976 Summer Olympics,19,Austria,AUT,68,0,0,1,1
1976 Summer Olympics,19,The Bahamas,BAH,11,0,0,0,0
1976 Summer Olympics,19,Barbados,BAR,11,0,0,0,0
1976 Summer Olympics,19,Belgium,BEL,104,0,3,6,9
1976 Summer Olympics,19,Bermuda,BER,20,0,0,1,1
1976 Summer Olympics,19,Belize,BIZ,4,0,0,0,0
1976 Summer Olympics,19,Bolivia,BOL,4,0,0,0,0
1976 Summer Olympics,19,Brazil,BRA,80,0,0,3,3
1976 Summer Olympics,19,Bulgaria,BUL,158,8,13,18,39
1976 Summer Olympics,19,Canada,CAN,392,0,9,14,23
1976 Summer Olympics,19,Cayman Islands,CAY,2,0,0,0,0
1976 Summer Olympics,19,Chile,CHI,7,0,0,0,0
1976 Summer Olympics,19,Côte d'Ivoire,CIV,8,0,0,0,0
1976 Summer Olympics,19,Cameroon,CMR,8,0,0,0,0
1976 Summer Olympics,19,Colombia,COL,35,0,0,0,0
1976 Summer Olympics,19,Costa Rica,CRC,5,0,0,0,0
1976 Summer Olympics,19,Cuba,CUB,166,6,4,14,24
1976 Summer Olympics,19,Denmark,DEN,67,3,0,5,8
1976 Summer Olympics,19,Dominican Republic,DOM,11,0,0,0,0
1976 Summer Olympics,19,Ecuador,ECU,5,0,0,0,0
1976 Summer Olympics,19,Egypt,EGY,32,0,0,0,0
1976 Summer Olympics,19,Spain,ESP,115,0,6,0,6
1976 Summer Olympics,19,Fiji,FIJ,2,0,0,0,0
1976 Summer Olympics,19,Finland,FIN,85,4,2,0,6
1976 Summer Olympics,19,France,FRA,214,5,7,8,20
1976 Summer Olympics,19,FRG,FRG,295,21,27,35,83
1976 Summer Olympics,19,Great Britain,GBR,247,6,15,11,32
1976 Summer Olympics,19,German Dem. Republic,GDR,272,107,53,42,202
1976 Summer Olympics,19,Greece,GRE,36,0,0,0,0
1976 Summer Olympics,19,Guatemala,GUA,28,0,0,0,0
1976 Summer Olympics,19,Haiti,HAI,13,0,0,0,0
1976 Summer Olympics,19,"Hong Kong, China",HKG,25,0,0,0,0
1976 Summer Olympics,19,Honduras,HON,3,0,0,0,0
1976 Summer Olympics,19,Hungary,HUN,187,14,6,35,55
1976 Summer Olympics,19,Indonesia,INA,7,0,0,0,0
1976 Summer Olympics,19,India,IND,26,0,0,0,0
1976 Summer Olympics,19,Islamic Republic of Iran,IRI,86,0,1,1,2
1976 Summer Olympics,19,Ireland,IRL,44,0,0,0,0
1976 Summer Olympics,19,Iceland,ISL,13,0,0,0,0
1976 Summer Olympics,19,Israel,ISR,28,0,0,0,0
1976 Summer Olympics,19,United States Virgin Islands,ISV,22,0,0,0,0
1976 Summer Olympics,19,Italy,ITA,218,2,25,4,31
1976 Summer Olympics,19,Jamaica,JAM,20,1,1,0,2
1976 Summer Olympics,19,Japan,JPN,213,25,6,10,41
1976 Summer Olympics,19,Republic of Korea,KOR,50,1,1,15,17
1976 Summer Olympics,19,Kingdom of Saudi Arabia,KSA,18,0,0,0,0
1976 Summer Olympics,19,Kuwait,KUW,15,0,0,0,0
1976 Summer Olympics,19,Lebanon,LBN,3,0,0,0,0
1976 Summer Olympics,19,Liechtenstein,LIE,6,0,0,0,0
1976 Summer Olympics,19,Luxembourg,LUX,8,0,0,0,0
1976 Summer Olympics,19,Morocco,MAR,12,0,0,0,0
1976 Summer Olympics,19,Malaysia,MAS,23,0,0,0,0
1976 Summer Olympics,19,Mexico,MEX,99,1,0,1,2
1976 Summer Olympics,19,Mongolia,MGL,32,0,1,0,1
1976 Summer Olympics,19,Monaco,MON,8,0,0,0,0
1976 Summer Olympics,19,Nicaragua,NCA,16,0,0,0,0
1976 Summer Olympics,19,Netherlands,NED,109,0,2,13,15
1976 Summer Olympics,19,Nepal,NEP,1,0,0,0,0
1976 Summer Olympics,19,Norway,NOR,67,2,4,0,6
1976 Summer Olympics,19,New Zealand,NZL,82,17,1,9,27
1976 Summer Olympics,19,Pakistan,PAK,24,0,0,16,16
1976 Summer Olympics,19,Panama,PAN,8,0,0,0,0
1976 Summer Olympics,19,Paraguay,PAR,4,0,0,0,0
1976 Summer Olympics,19,Peru,PER,13,0,0,0,0
1976 Summer Olympics,19,Philippines,PHI,14,0,0,0,0
1976 Summer Olympics,19,Papua New Guinea,PNG,6,0,0,0,0
1976 Summer Olympics,19,Poland,POL,221,18,31,26,75
1976 Summer Olympics,19,Portugal,POR,19,0,2,0,2
1976 Summer Olympics,19,Democratic People's Republic of Korea,PRK,40,1,1,0,2
1976 Summer Olympics,19,Puerto Rico,PUR,81,0,0,1,1
1976 Summer Olympics,19,Romania,ROU,157,4,28,23,55
1976 Summer Olympics,19,Senegal,SEN,24,0,0,0,0
1976 Summer Olympics,19,Singapore,SGP,4,0,0,0,0
1976 Summer Olympics,19,San Marino,SMR,10,0,0,0,0
1976 Summer Olympics,19,Switzerland,SUI,50,1,3,6,10
1976 Summer Olympics,19,Suriname,SUR,3,0,0,0,0
1976 Summer Olympics,19,Sweden,SWE,118,9,1,0,10
1976 Summer Olympics,19,Czechoslovakia,TCH,163,2,4,9,15
1976 Summer Olympics,19,Thailand,THA,43,0,0,1,1
1976 Summer Olympics,19,Trinidad and Tobago,TTO,13,1,0,0,1
1976 Summer Olympics,19,Tunisia,TUN,22,0,0,0,0
1976 Summer Olympics,19,Türkiye,TUR,27,0,0,0,0
1976 Summer Olympics,19,USSR,URS,412,114,95,85,294
1976 Summer Olympics,19,Uruguay,URU,9,0,0,0,0
1976 Summer Olympics,19,United States,USA,400,74,60,36,170
1976 Summer Olympics,19,Venezuela,VEN,33,0,1,0,1
1976 Summer Olympics,19,Yugoslavia,YUG,88,2,14,3,19
1976 Winter Olympics,40,Andorra,AND,5,0,0,0,0
1976 Winter Olympics,40,Argentina,ARG,8,0,0,0,0
1976 Winter Olympics,40,Australia,AUS,8,0,0,0,0
1976 Winter Olympics,40,Austria,AUT,77,2,2,3,7
1976 Winter Olympics,40,Belgium,BEL,4,0,0,0,0
1976 Winter Olympics,40,Bulgaria,BUL,29,0,0,0,0
1976 Winter Olympics,40,Canada,CAN,59,1,1,1,3
1976 Winter Olympics,40,Chile,CHI,5,0,0,0,0
1976 Winter Olympics,40,Spain,ESP,4,0,0,0,0
1976 Winter Olympics,40,Finland,FIN,47,5,10,1,16
1976 Winter Olympics,40,France,FRA,35,0,0,1,1
1976 Winter Olympics,40,FRG,FRG,71,2,7,23,32
1976 Winter Olympics,40,Great Britain,GBR,42,1,0,0,1
1976 Winter Olympics,40,German Dem. Republic,GDR,59,12,6,14,32
1976 Winter Olympics,40,Greece,GRE,4,0,0,0,0
1976 Winter Olympics,40,Hungary,HUN,3,0,0,0,0
1976 Winter Olympics,40,Islamic Republic of Iran,IRI,4,0,0,0,0
1976 Winter Olympics,40,Iceland,ISL,8,0,0,0,0
1976 Winter Olympics,40,Italy,ITA,58,1,2,1,4
1976 Winter Olympics,40,Japan,JPN,58,0,0,0,0
1976 Winter Olympics,40,Republic of Korea,KOR,3,0,0,0,0
1976 Winter Olympics,40,Lebanon,LBN,1,0,0,0,0
1976 Winter Olympics,40,Liechtenstein,LIE,9,0,0,2,2
1976 Winter Olympics,40,Netherlands,NED,9,1,2,3,6
1976 Winter Olympics,40,Norway,NOR,42,3,6,1,10
1976 Winter Olympics,40,New Zealand,NZL,5,0,0,0,0
1976 Winter Olympics,40,Poland,POL,56,0,0,0,0
1976 Winter Olympics,40,Romania,ROU,32,0,0,0,0
1976 Winter Olympics,40,San Marino,SMR,2,0,0,0,0
1976 Winter Olympics,40,Switzerland,SUI,59,1,6,2,9
1976 Winter Olympics,40,Sweden,SWE,39,0,0,2,2
1976 Winter Olympics,40,Czechoslovakia,TCH,58,0,19,0,19
1976 Winter Olympics,40,Chinese Taipei,TPE,6,0,0,0,0
1976 Winter Olympics,40,Türkiye,TUR,9,0,0,0,0
1976 Winter Olympics,40,USSR,URS,79,38,7,11,56
1976 Winter Olympics,40,United States,USA,109,3,3,5,11
1976 Winter Olympics,40,Yugoslavia,YUG,28,0,0,0,0
1980 Summer Olympics,20,Afghanistan,AFG,11,0,0,0,0
1980 Summer Olympics,20,Algeria,ALG,59,0,0,0,0
1980 Summer Olympics,20,Andorra,AND,2,0,0,0,0
1980 Summer Olympics,20,Angola,ANG,13,0,0,0,0
1980 Summer Olympics,20,Australia,AUS,120,6,2,5,13
1980 Summer Olympics,20,Austria,AUT,85,1,3,1,5
1980 Summer Olympics,20,Belgium,BEL,61,1,0,0,1
1980 Summer Olympics,20,Benin,BEN,16,0,0,0,0
1980 Summer Olympics,20,Botswana,BOT,7,0,0,0,0
1980 Summer Olympics,20,Brazil,BRA,107,4,0,5,9
1980 Summer Olympics,20,Bulgaria,BUL,282,8,44,40,92
1980 Summer Olympics,20,Congo,CGO,24,0,0,0,0
1980 Summer Olympics,20,Cameroon,CMR,26,0,0,0,0
1980 Summer Olympics,20,Colombia,COL,23,0,0,0,0
1980 Summer Olympics,20,Costa Rica,CRC,29,0,0,0,0
1980 Summer Olympics,20,Cuba,CUB,213,8,7,5,20
1980 Summer Olympics,20,Cyprus,CYP,14,0,0,0,0
1980 Summer Olympics,20,Denmark,DEN,58,4,2,2,8
1980 Summer Olympics,20,Dominican Republic,DOM,6,0,0,0,0
1980 Summer Olympics,20,Ecuador,ECU,12,0,0,0,0
1980 Summer Olympics,20,Spain,ESP,157,2,19,3,24
1980 Summer Olympics,20,Ethiopia,ETH,41,2,0,2,4
1980 Summer Olympics,20,Finland,FIN,114,3,1,5,9
1980 Summer Olympics,20,France,FRA,124,18,5,8,31
1980 Summer Olympics,20,Great Britain,GBR,227,5,18,30,53
1980 Summer Olympics,20,German Dem. Republic,GDR,352,117,92,61,270
1980 Summer Olympics,20,Greece,GRE,41,1,0,4,5
1980 Summer Olympics,20,Guatemala,GUA,10,0,0,0,0
1980 Summer Olympics,20,Guinea,GUI,9,0,0,0,0
1980 Summer Olympics,20,Guyana,GUY,8,0,0,1,1
1980 Summer Olympics,20,Hungary,HUN,271,8,13,40,61
1980 Summer Olympics,20,India,IND,74,16,0,0,16
1980 Summer Olympics,20,Ireland,IRL,47,0,2,1,3
1980 Summer Olympics,20,Iraq,IRQ,44,0,0,0,0
1980 Summer Olympics,20,Iceland,ISL,9,0,0,0,0
1980 Summer Olympics,20,Italy,ITA,162,8,21,10,39
1980 Summer Olympics,20,Jamaica,JAM,23,0,0,3,3
1980 Summer Olympics,20,Jordan,JOR,4,0,0,0,0
1980 Summer Olympics,20,Kuwait,KUW,60,0,0,0,0
1980 Summer Olympics,20,Lao People's Democratic Republic,LAO,19,0,0,0,0
1980 Summer Olympics,20,Libya,LBA,32,0,0,0,0
1980 Summer Olympics,20,Lebanon,LBN,15,0,0,1,1
1980 Summer Olympics,20,Lesotho,LES,5,0,0,0,0
1980 Summer Olympics,20,Luxembourg,LUX,3,0,0,0,0
1980 Summer Olympics,20,Madagascar,MAD,11,0,0,0,0
1980 Summer Olympics,20,Mexico,MEX,45,0,1,9,10
1980 Summer Olympics,20,Mongolia,MGL,43,0,2,2,4
1980 Summer Olympics,20,Mali,MLI,7,0,0,0,0
1980 Summer Olympics,20,Malta,MLT,8,0,0,0,0
1980 Summer Olympics,20,Mozambique,MOZ,14,0,0,0,0
1980 Summer Olympics,20,Myanmar,MYA,2,0,0,0,0
1980 Summer Olympics,20,Nicaragua,NCA,5,0,0,0,0
1980 Summer Olympics,20,Netherlands,NED,77,0,1,5,6
1980 Summer Olympics,20,Nepal,NEP,11,0,0,0,0
1980 Summer Olympics,20,Nigeria,NGR,50,0,0,0,0
1980 Summer Olympics,20,New Zealand,NZL,5,0,0,0,0
1980 Summer Olympics,20,Peru,PER,30,0,0,0,0
1980 Summer Olympics,20,Poland,POL,309,3,27,22,52
1980 Summer Olympics,20,Portugal,POR,11,0,0,0,0
1980 Summer Olympics,20,Democratic People's Republic of Korea,PRK,47,0,3,2,5
1980 Summer Olympics,20,Puerto Rico,PUR,3,0,0,0,0
1980 Summer Olympics,20,Romania,ROU,230,7,15,48,70
1980 Summer Olympics,20,Senegal,SEN,33,0,0,0,0
1980 Summer Olympics,20,Seychelles,SEY,11,0,0,0,0
1980 Summer Olympics,20,Sierra Leone,SLE,14,0,0,0,0
1980 Summer Olympics,20,San Marino,SMR,16,0,0,0,0
1980 Summer Olympics,20,Sri Lanka,SRI,5,0,0,0,0
1980 Summer Olympics,20,Switzerland,SUI,74,2,0,0,2
1980 Summer Olympics,20,Sweden,SWE,148,3,8,9,20
1980 Summer Olympics,20,Syrian Arab Republic,SYR,69,0,0,0,0
1980 Summer Olympics,20,United Republic of Tanzania,TAN,41,0,2,0,2
1980 Summer Olympics,20,Czechoslovakia,TCH,212,18,18,16,52
1980 Summer Olympics,20,Trinidad and Tobago,TTO,10,0,0,0,0
1980 Summer Olympics,20,Uganda,UGA,14,0,1,0,1
1980 Summer Olympics,20,USSR,URS,493,193,131,126,450
1980 Summer Olympics,20,Venezuela,VEN,38,0,1,0,1
1980 Summer Olympics,20,Vietnam,VIE,30,0,0,0,0
1980 Summer Olympics,20,Yugoslavia,YUG,165,13,27,17,57
1980 Summer Olympics,20,Zambia,ZAM,39,0,0,0,0
1980 Summer Olympics,20,Zimbabwe,ZIM,44,16,0,0,16
1980 Winter Olympics,41,Andorra,AND,3,0,0,0,0
1980 Winter Olympics,41,Argentina,ARG,13,0,0,0,0
1980 Winter Olympics,41,Australia,AUS,9,0,0,0,0
1980 Winter Olympics,41,Austria,AUT,43,3,2,3,8
1980 Winter Olympics,41,Belgium,BEL,2,0,0,0,0
1980 Winter Olympics,41,Bolivia,BOL,3,0,0,0,0
1980 Winter Olympics,41,Bulgaria,BUL,8,0,0,1,1
1980 Winter Olympics,41,Canada,CAN,59,0,1,1,2
1980 Winter Olympics,41,People's Republic of China,CHN,24,0,0,0,0
1980 Winter Olympics,41,Costa Rica,CRC,1,0,0,0,0
1980 Winter Olympics,41,Cyprus,CYP,3,0,0,0,0
1980 Winter Olympics,41,Spain,ESP,9,0,0,0,0
1980 Winter Olympics,41,Finland,FIN,54,1,5,6,12
1980 Winter Olympics,41,France,FRA,22,0,0,1,1
1980 Winter Olympics,41,FRG,FRG,80,0,2,6,8
1980 Winter Olympics,41,Great Britain,GBR,48,1,0,0,1
1980 Winter Olympics,41,German Dem. Republic,GDR,53,16,11,12,39
1980 Winter Olympics,41,Greece,GRE,3,0,0,0,0
1980 Winter Olympics,41,Hungary,HUN,2,0,2,0,2
1980 Winter Olympics,41,Iceland,ISL,6,0,0,0,0
1980 Winter Olympics,41,Italy,ITA,46,0,3,0,3
1980 Winter Olympics,41,Japan,JPN,50,0,1,0,1
1980 Winter Olympics,41,Republic of Korea,KOR,11,0,0,0,0
1980 Winter Olympics,41,Lebanon,LBN,5,0,0,0,0
1980 Winter Olympics,41,Liechtenstein,LIE,7,2,2,0,4
1980 Winter Olympics,41,Mongolia,MGL,3,0,0,0,0
1980 Winter Olympics,41,Netherlands,NED,29,1,2,1,4
1980 Winter Olympics,41,Norway,NOR,64,1,6,9,16
1980 Winter Olympics,41,New Zealand,NZL,5,0,0,0,0
1980 Winter Olympics,41,Poland,POL,30,0,0,0,0
1980 Winter Olympics,41,Romania,ROU,35,0,0,0,0
1980 Winter Olympics,41,Switzerland,SUI,44,2,4,3,9
1980 Winter Olympics,41,Sweden,SWE,61,3,0,20,23
1980 Winter Olympics,41,Czechoslovakia,TCH,41,0,0,1,1
1980 Winter Olympics,41,USSR,URS,86,18,29,7,54
1980 Winter Olympics,41,United States,USA,104,25,4,2,31
1980 Winter Olympics,41,Yugoslavia,YUG,15,0,0,0,0
1984 Summer Olympics,21,Netherlands Antilles,AHO,8,0,0,0,0
1984 Summer Olympics,21,Algeria,ALG,33,0,0,2,2
1984 Summer Olympics,21,Andorra,AND,2,0,0,0,0
1984 Summer Olympics,21,Antigua and Barbuda,ANT,14,0,0,0,0
1984 Summer Olympics,21,Argentina,ARG,86,0,0,0,0
1984 Summer Olympics,21,Australia,AUS,253,7,17,31,55
1984 Summer Olympics,21,Austria,AUT,105,1,1,1,3
1984 Summer Olympics,21,The Bahamas,BAH,22,0,0,0,0
1984 Summer Olympics,21,Bangladesh,BAN,1,0,0,0,0
1984 Summer Olympics,21,Barbados,BAR,16,0,0,0,0
1984 Summer Olympics,21,Belgium,BEL,64,1,2,2,5
1984 Summer Olympics,21,Benin,BEN,3,0,0,0,0
1984 Summer Olympics,21,Bermuda,BER,12,0,0,0,0
1984 Summer Olympics,21,Bhutan,BHU,6,0,0,0,0
1984 Summer Olympics,21,Belize,BIZ,11,0,0,0,0
1984 Summer Olympics,21,Bolivia,BOL,11,0,0,0,0
1984 Summer Olympics,21,Botswana,BOT,7,0,0,0,0
1984 Summer Olympics,21,Brazil,BRA,149,1,34,2,37
1984 Summer Olympics,21,Bahrain,BRN,10,0,0,0,0
1984 Summer Olympics,21,Central African Republic,CAF,3,0,0,0,0
1984 Summer Olympics,21,Canada,CAN,438,19,36,35,90
1984 Summer Olympics,21,Cayman Islands,CAY,8,0,0,0,0
1984 Summer Olympics,21,Congo,CGO,12,0,0,0,0
1984 Summer Olympics,21,Chad,CHA,3,0,0,0,0
1984 Summer Olympics,21,Chile,CHI,55,0,0,0,0
1984 Summer Olympics,21,People's Republic of China,CHN,222,26,13,39,78
1984 Summer Olympics,21,Côte d'Ivoire,CIV,15,0,1,0,1
1984 Summer Olympics,21,Cameroon,CMR,48,0,0,1,1
1984 Summer Olympics,21,Democratic Republic of the Congo,COD,8,0,0,0,0
1984 Summer Olympics,21,Colombia,COL,39,0,1,0,1
1984 Summer Olympics,21,Costa Rica,CRC,28,0,0,0,0
1984 Summer Olympics,21,Cyprus,CYP,10,0,0,0,0
1984 Summer Olympics,21,Denmark,DEN,64,0,3,10,13
1984 Summer Olympics,21,Djibouti,DJI,3,0,0,0,0
1984 Summer Olympics,21,Dominican Republic,DOM,39,0,0,1,1
1984 Summer Olympics,21,Ecuador,ECU,11,0,0,0,0
1984 Summer Olympics,21,Egypt,EGY,114,0,1,0,1
1984 Summer Olympics,21,El Salvador,ESA,10,0,0,0,0
1984 Summer Olympics,21,Spain,ESP,184,2,14,3,19
1984 Summer Olympics,21,Fiji,FIJ,15,0,0,0,0
1984 Summer Olympics,21,Finland,FIN,94,4,2,6,12
1984 Summer Olympics,21,France,FRA,248,21,16,31,68
1984 Summer Olympics,21,FRG,FRG,405,30,77,56,163
1984 Summer Olympics,21,Gabon,GAB,4,0,0,0,0
1984 Summer Olympics,21,The Gambia,GAM,10,0,0,0,0
1984 Summer Olympics,21,Great Britain,GBR,345,9,22,45,76
1984 Summer Olympics,21,Equatorial Guinea,GEQ,4,0,0,0,0
1984 Summer Olympics,21,Ghana,GHA,27,0,0,0,0
1984 Summer Olympics,21,Greece,GRE,65,0,1,1,2
1984 Summer Olympics,21,Grenada,GRN,7,0,0,0,0
1984 Summer Olympics,21,Guatemala,GUA,24,0,0,0,0
1984 Summer Olympics,21,Guinea,GUI,1,0,0,0,0
1984 Summer Olympics,21,Guyana,GUY,10,0,0,0,0
1984 Summer Olympics,21,Haiti,HAI,4,0,0,0,0
1984 Summer Olympics,21,"Hong Kong, China",HKG,48,0,0,0,0
1984 Summer Olympics,21,Honduras,HON,10,0,0,0,0
1984 Summer Olympics,21,Indonesia,INA,17,0,0,0,0
1984 Summer Olympics,21,India,IND,49,0,0,0,0
1984 Summer Olympics,21,Ireland,IRL,42,0,1,0,1
1984 Summer Olympics,21,Iraq,IRQ,25,0,0,0,0
1984 Summer Olympics,21,Iceland,ISL,30,0,0,1,1
1984 Summer Olympics,21,Israel,ISR,33,0,0,0,0
1984 Summer Olympics,21,United States Virgin Islands,ISV,34,0,0,0,0
1984 Summer Olympics,21,Italy,ITA,298,30,6,28,64
1984 Summer Olympics,21,British Virgin Islands,IVB,9,0,0,0,0
1984 Summer Olympics,21,Jamaica,JAM,47,0,7,2,9
1984 Summer Olympics,21,Jordan,JOR,13,0,0,0,0
1984 Summer Olympics,21,Japan,JPN,255,10,8,31,49
1984 Summer Olympics,21,Kenya,KEN,61,1,0,2,3
1984 Summer Olympics,21,Republic of Korea,KOR,202,6,31,7,44
1984 Summer Olympics,21,Kingdom of Saudi Arabia,KSA,41,0,0,0,0
1984 Summer Olympics,21,Kuwait,KUW,26,0,0,0,0
1984 Summer Olympics,21,Lebanon,LBN,22,0,0,0,0
1984 Summer Olympics,21,Liberia,LBR,7,0,0,0,0
1984 Summer Olympics,21,Lesotho,LES,4,0,0,0,0
1984 Summer Olympics,21,Liechtenstein,LIE,7,0,0,0,0
1984 Summer Olympics,21,Luxembourg,LUX,5,0,0,0,0
1984 Summer Olympics,21,Madagascar,MAD,5,0,0,0,0
1984 Summer Olympics,21,Morocco,MAR,37,2,0,0,2
1984 Summer Olympics,21,Malaysia,MAS,21,0,0,0,0
1984 Summer Olympics,21,Malawi,MAW,15,0,0,0,0
1984 Summer Olympics,21,Mexico,MEX,101,2,3,1,6
1984 Summer Olympics,21,Mali,MLI,4,0,0,0,0
1984 Summer Olympics,21,Malta,MLT,7,0,0,0,0
1984 Summer Olympics,21,Monaco,MON,8,0,0,0,0
1984 Summer Olympics,21,Mozambique,MOZ,9,0,0,0,0
1984 Summer Olympics,21,Mauritius,MRI,4,0,0,0,0
1984 Summer Olympics,21,Mauritania,MTN,2,0,0,0,0
1984 Summer Olympics,21,Myanmar,MYA,1,0,0,0,0
1984 Summer Olympics,21,Nicaragua,NCA,25,0,0,0,0
1984 Summer Olympics,21,Netherlands,NED,142,20,7,14,41
1984 Summer Olympics,21,Nepal,NEP,11,0,0,0,0
1984 Summer Olympics,21,Nigeria,NGR,34,0,1,5,6
1984 Summer Olympics,21,Niger,NIG,4,0,0,0,0
1984 Summer Olympics,21,Norway,NOR,107,0,1,3,4
1984 Summer Olympics,21,New Zealand,NZL,130,16,1,6,23
1984 Summer Olympics,21,Oman,OMA,16,0,0,0,0
1984 Summer Olympics,21,Pakistan,PAK,31,16,0,0,16
1984 Summer Olympics,21,Panama,PAN,8,0,0,0,0
1984 Summer Olympics,21,Paraguay,PAR,14,0,0,0,0
1984 Summer Olympics,21,Peru,PER,39,0,1,0,1
1984 Summer Olympics,21,Philippines,PHI,20,0,0,0,0
1984 Summer Olympics,21,Papua New Guinea,PNG,7,0,0,0,0
1984 Summer Olympics,21,Portugal,POR,38,1,0,2,3
1984 Summer Olympics,21,Puerto Rico,PUR,52,0,1,1,2
1984 Summer Olympics,21,Qatar,QAT,28,0,0,0,0
1984 Summer Olympics,21,Romania,ROU,124,40,31,35,106
1984 Summer Olympics,21,Rwanda,RWA,3,0,0,0,0
1984 Summer Olympics,21,Samoa,SAM,8,0,0,0,0
1984 Summer Olympics,21,Senegal,SEN,24,0,0,0,0
1984 Summer Olympics,21,Seychelles,SEY,9,0,0,0,0
1984 Summer Olympics,21,Singapore,SGP,5,0,0,0,0
1984 Summer Olympics,21,Sierra Leone,SLE,10,0,0,0,0
1984 Summer Olympics,21,San Marino,SMR,19,0,0,0,0
1984 Summer Olympics,21,Solomon Islands,SOL,3,0,0,0,0
1984 Summer Olympics,21,Somalia,SOM,7,0,0,0,0
1984 Summer Olympics,21,Sri Lanka,SRI,4,0,0,0,0
1984 Summer Olympics,21,Sudan,SUD,7,0,0,0,0
1984 Summer Olympics,21,Switzerland,SUI,137,0,9,4,13
1984 Summer Olympics,21,Suriname,SUR,5,0,0,0,0
1984 Summer Olympics,21,Sweden,SWE,180,3,18,14,35
1984 Summer Olympics,21,Eswatini,SWZ,8,0,0,0,0
1984 Summer Olympics,21,Syrian Arab Republic,SYR,9,0,1,0,1
1984 Summer Olympics,21,United Republic of Tanzania,TAN,19,0,0,0,0
1984 Summer Olympics,21,Tonga,TGA,7,0,0,0,0
1984 Summer Olympics,21,Thailand,THA,42,0,1,0,1
1984 Summer Olympics,21,Togo,TOG,6,0,0,0,0
1984 Summer Olympics,21,Chinese Taipei,TPE,59,0,0,1,1
1984 Summer Olympics,21,Trinidad and Tobago,TTO,17,0,0,0,0
1984 Summer Olympics,21,Tunisia,TUN,23,0,0,0,0
1984 Summer Olympics,21,Türkiye,TUR,46,0,0,3,3
1984 Summer Olympics,21,United Arab Emirates,UAE,8,0,0,0,0
1984 Summer Olympics,21,Uganda,UGA,26,0,0,0,0
1984 Summer Olympics,21,Uruguay,URU,19,0,0,0,0
1984 Summer Olympics,21,United States,USA,577,193,116,50,359
1984 Summer Olympics,21,Venezuela,VEN,26,0,0,3,3
1984 Summer Olympics,21,North Yemen,YAR,2,0,0,0,0
1984 Summer Olympics,21,Yugoslavia,YUG,143,48,5,35,88
1984 Summer Olympics,21,Zambia,ZAM,16,0,0,1,1
1984 Summer Olympics,21,Zimbabwe,ZIM,16,0,0,0,0
1984 Winter Olympics,42,Andorra,AND,2,0,0,0,0
1984 Winter Olympics,42,Argentina,ARG,18,0,0,0,0
1984 Winter Olympics,42,Australia,AUS,11,0,0,0,0
1984 Winter Olympics,42,Austria,AUT,70,0,0,1,1
1984 Winter Olympics,42,Belgium,BEL,4,0,0,0,0
1984 Winter Olympics,42,Bolivia,BOL,3,0,0,0,0
1984 Winter Olympics,42,Bulgaria,BUL,16,0,0,0,0
1984 Winter Olympics,42,Canada,CAN,69,2,1,1,4
1984 Winter Olympics,42,Chile,CHI,4,0,0,0,0
1984 Winter Olympics,42,People's Republic of China,CHN,37,0,0,0,0
1984 Winter Olympics,42,Costa Rica,CRC,3,0,0,0,0
1984 Winter Olympics,42,Cyprus,CYP,5,0,0,0,0
1984 Winter Olympics,42,Egypt,EGY,1,0,0,0,0
1984 Winter Olympics,42,Spain,ESP,14,0,0,0,0
1984 Winter Olympics,42,Finland,FIN,45,4,3,12,19
1984 Winter Olympics,42,France,FRA,33,0,1,2,3
1984 Winter Olympics,42,FRG,FRG,88,3,1,4,8
1984 Winter Olympics,42,Great Britain,GBR,50,2,0,0,2
1984 Winter Olympics,42,German Dem. Republic,GDR,56,13,13,7,33
1984 Winter Olympics,42,Greece,GRE,6,0,0,0,0
1984 Winter Olympics,42,Hungary,HUN,9,0,0,0,0
1984 Winter Olympics,42,Iceland,ISL,5,0,0,0,0
1984 Winter Olympics,42,Italy,ITA,74,2,0,0,2
1984 Winter Olympics,42,British Virgin Islands,IVB,1,0,0,0,0
1984 Winter Olympics,42,Japan,JPN,39,0,1,0,1
1984 Winter Olympics,42,Republic of Korea,KOR,15,0,0,0,0
1984 Winter Olympics,42,Lebanon,LBN,4,0,0,0,0
1984 Winter Olympics,42,Liechtenstein,LIE,10,0,0,2,2
1984 Winter Olympics,42,Morocco,MAR,4,0,0,0,0
1984 Winter Olympics,42,Mexico,MEX,1,0,0,0,0
1984 Winter Olympics,42,Mongolia,MGL,4,0,0,0,0
1984 Winter Olympics,42,Monaco,MON,1,0,0,0,0
1984 Winter Olympics,42,Netherlands,NED,13,0,0,0,0
1984 Winter Olympics,42,Norway,NOR,59,6,5,4,15
1984 Winter Olympics,42,New Zealand,NZL,6,0,0,0,0
1984 Winter Olympics,42,Poland,POL,30,0,0,0,0
1984 Winter Olympics,42,Democratic People's Republic of Korea,PRK,6,0,0,0,0
1984 Winter Olympics,42,Puerto Rico,PUR,1,0,0,0,0
1984 Winter Olympics,42,Romania,ROU,20,0,0,0,0
1984 Winter Olympics,42,Senegal,SEN,1,0,0,0,0
1984 Winter Olympics,42,San Marino,SMR,3,0,0,0,0
1984 Winter Olympics,42,Switzerland,SUI,48,2,2,4,8
1984 Winter Olympics,42,Sweden,SWE,63,7,2,21,30
1984 Winter Olympics,42,Czechoslovakia,TCH,50,0,24,4,28
1984 Winter Olympics,42,Chinese Taipei,TPE,12,0,0,0,0
1984 Winter Olympics,42,Türkiye,TUR,7,0,0,0,0
1984 Winter Olympics,42,USSR,URS,99,29,15,12,56
1984 Winter Olympics,42,United States,USA,110,4,5,0,9
1984 Winter Olympics,42,Yugoslavia,YUG,76,0,1,0,1
1988 Summer Olympics,22,Afghanistan,AFG,5,0,0,0,0
1988 Summer Olympics,22,Netherlands Antilles,AHO,3,0,1,0,1
1988 Summer Olympics,22,Algeria,ALG,45,0,0,0,0
1988 Summer Olympics,22,Andorra,AND,3,0,0,0,0
1988 Summer Olympics,22,Angola,ANG,25,0,0,0,0
1988 Summer Olympics,22,Antigua and Barbuda,ANT,16,0,0,0,0
1988 Summer Olympics,22,Argentina,ARG,123,0,1,12,13
1988 Summer Olympics,22,Aruba,ARU,8,0,0,0,0
1988 Summer Olympics,22,American Samoa,ASA,6,0,0,0,0
1988 Summer Olympics,22,Australia,AUS,284,18,6,11,35
1988 Summer Olympics,22,Austria,AUT,83,1,0,0,1
1988 Summer Olympics,22,The Bahamas,BAH,16,0,0,0,0
1988 Summer Olympics,22,Bangladesh,BAN,6,0,0,0,0
1988 Summer Olympics,22,Barbados,BAR,18,0,0,0,0
1988 Summer Olympics,22,Belgium,BEL,61,0,0,2,2
1988 Summer Olympics,22,Benin,BEN,7,0,0,0,0
1988 Summer Olympics,22,Bermuda,BER,12,0,0,0,0
1988 Summer Olympics,22,Bhutan,BHU,3,0,0,0,0
1988 Summer Olympics,22,Belize,BIZ,10,0,0,0,0
1988 Summer Olympics,22,Bolivia,BOL,7,0,0,0,0
1988 Summer Olympics,22,Botswana,BOT,8,0,0,0,0
1988 Summer Olympics,22,Brazil,BRA,168,1,21,5,27
1988 Summer Olympics,22,Bahrain,BRN,11,0,0,0,0
1988 Summer Olympics,22,Bulgaria,BUL,172,10,14,17,41
1988 Summer Olympics,22,Burkina Faso,BUR,6,0,0,0,0
1988 Summer Olympics,22,Central African Republic,CAF,15,0,0,0,0
1988 Summer Olympics,22,Canada,CAN,362,4,5,14,23
1988 Summer Olympics,22,Cayman Islands,CAY,8,0,0,0,0
1988 Summer Olympics,22,Congo,CGO,8,0,0,0,0
1988 Summer Olympics,22,Chad,CHA,6,0,0,0,0
1988 Summer Olympics,22,Chile,CHI,17,0,1,0,1
1988 Summer Olympics,22,People's Republic of China,CHN,294,6,16,31,53
1988 Summer Olympics,22,Côte d'Ivoire,CIV,31,0,0,0,0
1988 Summer Olympics,22,Cameroon,CMR,15,0,0,0,0
1988 Summer Olympics,22,Democratic Republic of the Congo,COD,16,0,0,0,0
1988 Summer Olympics,22,Cook Islands,COK,7,0,0,0,0
1988 Summer Olympics,22,Colombia,COL,43,0,0,1,1
1988 Summer Olympics,22,Costa Rica,CRC,16,0,1,0,1
1988 Summer Olympics,22,Cyprus,CYP,10,0,0,0,0
1988 Summer Olympics,22,Denmark,DEN,89,3,1,3,7
1988 Summer Olympics,22,Djibouti,DJI,6,0,0,1,1
1988 Summer Olympics,22,Dominican Republic,DOM,16,0,0,0,0
1988 Summer Olympics,22,Ecuador,ECU,16,0,0,0,0
1988 Summer Olympics,22,Egypt,EGY,54,0,0,0,0
1988 Summer Olympics,22,El Salvador,ESA,6,0,0,0,0
1988 Summer Olympics,22,Spain,ESP,248,1,2,2,5
1988 Summer Olympics,22,Fiji,FIJ,23,0,0,0,0
1988 Summer Olympics,22,Finland,FIN,81,1,1,2,4
1988 Summer Olympics,22,France,FRA,278,12,4,15,31
1988 Summer Olympics,22,FRG,FRG,369,32,37,48,117
1988 Summer Olympics,22,Gabon,GAB,3,0,0,0,0
1988 Summer Olympics,22,The Gambia,GAM,6,0,0,0,0
1988 Summer Olympics,22,Great Britain,GBR,359,22,18,15,55
1988 Summer Olympics,22,German Dem. Republic,GDR,263,79,56,50,185
1988 Summer Olympics,22,Equatorial Guinea,GEQ,6,0,0,0,0
1988 Summer Olympics,22,Ghana,GHA,18,0,0,0,0
1988 Summer Olympics,22,Greece,GRE,56,0,0,1,1
1988 Summer Olympics,22,Grenada,GRN,6,0,0,0,0
1988 Summer Olympics,22,Guatemala,GUA,30,0,0,0,0
1988 Summer Olympics,22,Guinea,GUI,6,0,0,0,0
1988 Summer Olympics,22,Guam,GUM,19,0,0,0,0
1988 Summer Olympics,22,Guyana,GUY,8,0,0,0,0
1988 Summer Olympics,22,Haiti,HAI,4,0,0,0,0
1988 Summer Olympics,22,"Hong Kong, China",HKG,50,0,0,0,0
1988 Summer Olympics,22,Honduras,HON,8,0,0,0,0
1988 Summer Olympics,22,Hungary,HUN,194,20,9,15,44
1988 Summer Olympics,22,Indonesia,INA,32,0,3,0,3
1988 Summer Olympics,22,India,IND,48,0,0,0,0
1988 Summer Olympics,22,Islamic Republic of Iran,IRI,27,0,1,0,1
1988 Summer Olympics,22,Ireland,IRL,61,0,0,0,0
1988 Summer Olympics,22,Iraq,IRQ,31,0,0,0,0
1988 Summer Olympics,22,Iceland,ISL,32,0,0,0,0
1988 Summer Olympics,22,Israel,ISR,19,0,0,0,0
1988 Summer Olympics,22,United States Virgin Islands,ISV,26,0,1,0,1
1988 Summer Olympics,22,Italy,ITA,264,11,10,8,29
1988 Summer Olympics,22,British Virgin Islands,IVB,3,0,0,0,0
1988 Summer Olympics,22,Jamaica,JAM,35,0,7,0,7
1988 Summer Olympics,22,Jordan,JOR,9,0,0,0,0
1988 Summer Olympics,22,Japan,JPN,289,4,3,13,20
1988 Summer Olympics,22,Kenya,KEN,75,5,2,2,9
1988 Summer Olympics,22,Republic of Korea,KOR,463,31,39,12,82
1988 Summer Olympics,22,Kingdom of Saudi Arabia,KSA,14,0,0,0,0
1988 Summer Olympics,22,Kuwait,KUW,27,0,0,0,0
1988 Summer Olympics,22,Lao People's Democratic Republic,LAO,3,0,0,0,0
1988 Summer Olympics,22,Libya,LBA,6,0,0,0,0
1988 Summer Olympics,22,Lebanon,LBN,21,0,0,0,0
1988 Summer Olympics,22,Liberia,LBR,8,0,0,0,0
1988 Summer Olympics,22,Lesotho,LES,6,0,0,0,0
1988 Summer Olympics,22,Liechtenstein,LIE,12,0,0,0,0
1988 Summer Olympics,22,Luxembourg,LUX,8,0,0,0,0
1988 Summer Olympics,22,Morocco,MAR,28,1,0,2,3
1988 Summer Olympics,22,Malaysia,MAS,15,0,0,0,0
1988 Summer Olympics,22,Malawi,MAW,16,0,0,0,0
1988 Summer Olympics,22,Maldives,MDV,7,0,0,0,0
1988 Summer Olympics,22,Mexico,MEX,89,0,0,2,2
1988 Summer Olympics,22,Mongolia,MGL,28,0,0,1,1
1988 Summer Olympics,22,Mali,MLI,6,0,0,0,0
1988 Summer Olympics,22,Malta,MLT,6,0,0,0,0
1988 Summer Olympics,22,Monaco,MON,9,0,0,0,0
1988 Summer Olympics,22,Mozambique,MOZ,8,0,0,0,0
1988 Summer Olympics,22,Mauritius,MRI,8,0,0,0,0
1988 Summer Olympics,22,Mauritania,MTN,6,0,0,0,0
1988 Summer Olympics,22,Myanmar,MYA,2,0,0,0,0
1988 Summer Olympics,22,Netherlands,NED,179,3,6,36,45
1988 Summer Olympics,22,Nepal,NEP,18,0,0,0,0
1988 Summer Olympics,22,Nigeria,NGR,75,0,0,0,0
1988 Summer Olympics,22,Niger,NIG,8,0,0,0,0
1988 Summer Olympics,22,Norway,NOR,71,2,21,0,23
1988 Summer Olympics,22,New Zealand,NZL,88,4,4,16,24
1988 Summer Olympics,22,Oman,OMA,10,0,0,0,0
1988 Summer Olympics,22,Pakistan,PAK,31,0,0,1,1
1988 Summer Olympics,22,Panama,PAN,6,0,0,0,0
1988 Summer Olympics,22,Paraguay,PAR,10,0,0,0,0
1988 Summer Olympics,22,Peru,PER,21,0,12,0,12
1988 Summer Olympics,22,Philippines,PHI,34,0,0,1,1
1988 Summer Olympics,22,Papua New Guinea,PNG,11,0,0,0,0
1988 Summer Olympics,22,Poland,POL,147,2,9,10,21
1988 Summer Olympics,22,Portugal,POR,66,1,0,0,1
1988 Summer Olympics,22,Puerto Rico,PUR,69,0,0,0,0
1988 Summer Olympics,22,Qatar,QAT,12,0,0,0,0
1988 Summer Olympics,22,Romania,ROU,68,8,34,16,58
1988 Summer Olympics,22,Rwanda,RWA,6,0,0,0,0
1988 Summer Olympics,22,Samoa,SAM,11,0,0,0,0
1988 Summer Olympics,22,Senegal,SEN,23,0,1,0,1
1988 Summer Olympics,22,Singapore,SGP,9,0,0,0,0
1988 Summer Olympics,22,Sierra Leone,SLE,12,0,0,0,0
1988 Summer Olympics,22,San Marino,SMR,11,0,0,0,0
1988 Summer Olympics,22,Solomon Islands,SOL,5,0,0,0,0
1988 Summer Olympics,22,Somalia,SOM,5,0,0,0,0
1988 Summer Olympics,22,Sri Lanka,SRI,6,0,0,0,0
1988 Summer Olympics,22,Sudan,SUD,8,0,0,0,0
1988 Summer Olympics,22,Switzerland,SUI,100,0,6,2,8
1988 Summer Olympics,22,Suriname,SUR,6,1,0,0,1
1988 Summer Olympics,22,Sweden,SWE,195,0,5,11,16
1988 Summer Olympics,22,Eswatini,SWZ,12,0,0,0,0
1988 Summer Olympics,22,Syrian Arab Republic,SYR,13,0,0,0,0
1988 Summer Olympics,22,United Republic of Tanzania,TAN,10,0,0,0,0
1988 Summer Olympics,22,Czechoslovakia,TCH,165,3,4,3,10
1988 Summer Olympics,22,Tonga,TGA,5,0,0,0,0
1988 Summer Olympics,22,Thailand,THA,16,0,0,1,1
1988 Summer Olympics,22,Togo,TOG,6,0,0,0,0
1988 Summer Olympics,22,Chinese Taipei,TPE,89,0,0,0,0
1988 Summer Olympics,22,Trinidad and Tobago,TTO,6,0,0,0,0
1988 Summer Olympics,22,Tunisia,TUN,42,0,0,0,0
1988 Summer Olympics,22,Türkiye,TUR,49,1,1,0,2
1988 Summer Olympics,22,United Arab Emirates,UAE,12,0,0,0,0
1988 Summer Olympics,22,Uganda,UGA,25,0,0,0,0
1988 Summer Olympics,22,USSR,URS,487,140,67,100,307
1988 Summer Olympics,22,Uruguay,URU,15,0,0,0,0
1988 Summer Olympics,22,United States,USA,583,89,69,54,212
1988 Summer Olympics,22,Vanuatu,VAN,6,0,0,0,0
1988 Summer Olympics,22,Venezuela,VEN,18,0,0,0,0
1988 Summer Olympics,22,Vietnam,VIE,9,0,0,0,0
1988 Summer Olympics,22,Saint Vincent and the Grenadines,VIN,8,0,0,0,0
1988 Summer Olympics,22,North Yemen,YAR,8,0,0,0,0
1988 Summer Olympics,22,South Yemen,YMD,5,0,0,0,0
1988 Summer Olympics,22,Yugoslavia,YUG,160,15,27,21,63
1988 Summer Olympics,22,Zambia,ZAM,31,0,0,0,0
1988 Summer Olympics,22,Zimbabwe,ZIM,30,0,0,0,0
1988 Winter Olympics,43,Netherlands Antilles,AHO,2,0,0,0,0
1988 Winter Olympics,43,Andorra,AND,4,0,0,0,0
1988 Winter Olympics,43,Argentina,ARG,15,0,0,0,0
1988 Winter Olympics,43,Australia,AUS,23,0,0,0,0
1988 Winter Olympics,43,Austria,AUT,91,3,5,4,12
1988 Winter Olympics,43,Belgium,BEL,4,0,0,0,0
1988 Winter Olympics,43,Bolivia,BOL,6,0,0,0,0
1988 Winter Olympics,43,Bulgaria,BUL,27,0,0,0,0
1988 Winter Olympics,43,Canada,CAN,141,0,2,4,6
1988 Winter Olympics,43,Chile,CHI,5,0,0,0,0
1988 Winter Olympics,43,People's Republic of China,CHN,17,0,0,0,0
1988 Winter Olympics,43,Costa Rica,CRC,2,0,0,0,0
1988 Winter Olympics,43,Cyprus,CYP,3,0,0,0,0
1988 Winter Olympics,43,Denmark,DEN,11,0,0,0,0
1988 Winter Olympics,43,Spain,ESP,13,0,0,0,0
1988 Winter Olympics,43,Fiji,FIJ,1,0,0,0,0
1988 Winter Olympics,43,Finland,FIN,59,7,23,5,35
1988 Winter Olympics,43,France,FRA,90,1,0,1,2
1988 Winter Olympics,43,FRG,FRG,106,4,7,3,14
1988 Winter Olympics,43,Great Britain,GBR,60,0,0,0,0
1988 Winter Olympics,43,German Dem. Republic,GDR,54,10,15,7,32
1988 Winter Olympics,43,Greece,GRE,7,0,0,0,0
1988 Winter Olympics,43,Guatemala,GUA,6,0,0,0,0
1988 Winter Olympics,43,Guam,GUM,1,0,0,0,0
1988 Winter Olympics,43,Hungary,HUN,5,0,0,0,0
1988 Winter Olympics,43,India,IND,3,0,0,0,0
1988 Winter Olympics,43,Iceland,ISL,3,0,0,0,0
1988 Winter Olympics,43,United States Virgin Islands,ISV,6,0,0,0,0
1988 Winter Olympics,43,Italy,ITA,70,2,1,5,8
1988 Winter Olympics,43,Jamaica,JAM,4,0,0,0,0
1988 Winter Olympics,43,Japan,JPN,58,0,0,1,1
1988 Winter Olympics,43,Republic of Korea,KOR,28,0,0,0,0
1988 Winter Olympics,43,Lebanon,LBN,4,0,0,0,0
1988 Winter Olympics,43,Liechtenstein,LIE,13,0,0,1,1
1988 Winter Olympics,43,Luxembourg,LUX,1,0,0,0,0
1988 Winter Olympics,43,Morocco,MAR,3,0,0,0,0
1988 Winter Olympics,43,Mexico,MEX,11,0,0,0,0
1988 Winter Olympics,43,Mongolia,MGL,3,0,0,0,0
1988 Winter Olympics,43,Monaco,MON,3,0,0,0,0
1988 Winter Olympics,43,Netherlands,NED,21,3,2,2,7
1988 Winter Olympics,43,Norway,NOR,80,0,6,5,11
1988 Winter Olympics,43,New Zealand,NZL,9,0,0,0,0
1988 Winter Olympics,43,Philippines,PHI,1,0,0,0,0
1988 Winter Olympics,43,Poland,POL,33,0,0,0,0
1988 Winter Olympics,43,Portugal,POR,5,0,0,0,0
1988 Winter Olympics,43,Democratic People's Republic of Korea,PRK,6,0,0,0,0
1988 Winter Olympics,43,Puerto Rico,PUR,10,0,0,0,0
1988 Winter Olympics,43,Romania,ROU,11,0,0,0,0
1988 Winter Olympics,43,San Marino,SMR,5,0,0,0,0
1988 Winter Olympics,43,Switzerland,SUI,87,8,7,5,20
1988 Winter Olympics,43,Sweden,SWE,84,7,0,24,31
1988 Winter Olympics,43,Czechoslovakia,TCH,60,0,1,5,6
1988 Winter Olympics,43,Chinese Taipei,TPE,13,0,0,0,0
1988 Winter Olympics,43,Türkiye,TUR,8,0,0,0,0
1988 Winter Olympics,43,USSR,URS,110,41,14,12,67
1988 Winter Olympics,43,United States,USA,152,2,1,4,7
1988 Winter Olympics,43,Yugoslavia,YUG,22,0,5,1,6
1992 Summer Olympics,23,Netherlands Antilles,AHO,4,0,0,0,0
1992 Summer Olympics,23,Albania,ALB,7,0,0,0,0
1992 Summer Olympics,23,Algeria,ALG,37,1,0,1,2
1992 Summer Olympics,23,Andorra,AND,8,0,0,0,0
1992 Summer Olympics,23,Angola,ANG,39,0,0,0,0
1992 Summer Olympics,23,Antigua and Barbuda,ANT,13,0,0,0,0
1992 Summer Olympics,23,Argentina,ARG,106,0,0,2,2
1992 Summer Olympics,23,Aruba,ARU,5,0,0,0,0
1992 Summer Olympics,23,American Samoa,ASA,3,0,0,0,0
1992 Summer Olympics,23,Australia,AUS,295,14,27,16,57
1992 Summer Olympics,23,Austria,AUT,106,0,6,0,6
1992 Summer Olympics,23,The Bahamas,BAH,14,0,0,1,1
1992 Summer Olympics,23,Bangladesh,BAN,6,0,0,0,0
1992 Summer Olympics,23,Barbados,BAR,17,0,0,0,0
1992 Summer Olympics,23,Belgium,BEL,68,0,1,2,3
1992 Summer Olympics,23,Benin,BEN,6,0,0,0,0
1992 Summer Olympics,23,Bermuda,BER,20,0,0,0,0
1992 Summer Olympics,23,Bhutan,BHU,6,0,0,0,0
1992 Summer Olympics,23,Bosnia and Herzegovina,BIH,10,0,0,0,0
1992 Summer Olympics,23,Belize,BIZ,10,0,0,0,0
1992 Summer Olympics,23,Bolivia,BOL,14,0,0,0,0
1992 Summer Olympics,23,Botswana,BOT,6,0,0,0,0
1992 Summer Olympics,23,Brazil,BRA,193,13,1,0,14
1992 Summer Olympics,23,Bahrain,BRN,11,0,0,0,0
1992 Summer Olympics,23,Bulgaria,BUL,138,3,7,7,17
1992 Summer Olympics,23,Burkina Faso,BUR,4,0,0,0,0
1992 Summer Olympics,23,Central African Republic,CAF,15,0,0,0,0
1992 Summer Olympics,23,Canada,CAN,302,27,5,12,44
1992 Summer Olympics,23,Cayman Islands,CAY,10,0,0,0,0
1992 Summer Olympics,23,Congo,CGO,7,0,0,0,0
1992 Summer Olympics,23,Chad,CHA,6,0,0,0,0
1992 Summer Olympics,23,Chile,CHI,14,0,0,0,0
1992 Summer Olympics,23,People's Republic of China,CHN,245,18,46,19,83
1992 Summer Olympics,23,Côte d'Ivoire,CIV,13,0,0,0,0
1992 Summer Olympics,23,Cameroon,CMR,9,0,0,0,0
1992 Summer Olympics,23,Democratic Republic of the Congo,COD,17,0,0,0,0
1992 Summer Olympics,23,Cook Islands,COK,2,0,0,0,0
1992 Summer Olympics,23,Colombia,COL,50,0,0,1,1
1992 Summer Olympics,23,Costa Rica,CRC,16,0,0,0,0
1992 Summer Olympics,23,Croatia,CRO,40,0,12,3,15
1992 Summer Olympics,23,Cuba,CUB,185,44,13,14,71
1992 Summer Olympics,23,Cyprus,CYP,17,0,0,0,0
1992 Summer Olympics,23,Denmark,DEN,119,3,2,9,14
1992 Summer Olympics,23,Djibouti,DJI,8,0,0,0,0
1992 Summer Olympics,23,Dominican Republic,DOM,32,0,0,0,0
1992 Summer Olympics,23,Ecuador,ECU,13,0,0,0,0
1992 Summer Olympics,23,Egypt,EGY,82,0,0,0,0
1992 Summer Olympics,23,El Salvador,ESA,4,0,0,0,0
1992 Summer Olympics,23,Spain,ESP,485,52,20,2,74
1992 Summer Olympics,23,Estonia,EST,37,1,0,2,3
1992 Summer Olympics,23,Ethiopia,ETH,20,1,0,2,3
1992 Summer Olympics,23,Unified Team,EUN,490,96,65,69,230
1992 Summer Olympics,23,Fiji,FIJ,18,0,0,0,0
1992 Summer Olympics,23,Finland,FIN,88,1,4,2,7
1992 Summer Olympics,23,France,FRA,376,9,5,43,57
1992 Summer Olympics,23,Gabon,GAB,5,0,0,0,0
1992 Summer Olympics,23,The Gambia,GAM,5,0,0,0,0
1992 Summer Olympics,23,Great Britain,GBR,375,8,3,39,50
1992 Summer Olympics,23,Equatorial Guinea,GEQ,7,0,0,0,0
1992 Summer Olympics,23,Germany,GER,481,81,57,61,199
1992 Summer Olympics,23,Ghana,GHA,35,0,0,20,20
1992 Summer Olympics,23,Greece,GRE,72,2,0,0,2
1992 Summer Olympics,23,Grenada,GRN,4,0,0,0,0
1992 Summer Olympics,23,Guatemala,GUA,14,0,0,0,0
1992 Summer Olympics,23,Guinea,GUI,8,0,0,0,0
1992 Summer Olympics,23,Guam,GUM,22,0,0,0,0
1992 Summer Olympics,23,Guyana,GUY,6,0,0,0,0
1992 Summer Olympics,23,Haiti,HAI,7,0,0,0,0
1992 Summer Olympics,23,"Hong Kong, China",HKG,38,0,0,0,0
1992 Summer Olympics,23,Honduras,HON,10,0,0,0,0
1992 Summer Olympics,23,Hungary,HUN,220,14,23,8,45
1992 Summer Olympics,23,Indonesia,INA,46,2,3,1,6
1992 Summer Olympics,23,India,IND,53,0,0,0,0
1992 Summer Olympics,23,IOA,IOA,58,0,1,2,3
1992 Summer Olympics,23,Islamic Republic of Iran,IRI,40,0,1,2,3
1992 Summer Olympics,23,Ireland,IRL,58,1,1,0,2
1992 Summer Olympics,23,Iraq,IRQ,8,0,0,0,0
1992 Summer Olympics,23,Iceland,ISL,29,0,0,0,0
1992 Summer Olympics,23,Israel,ISR,30,0,1,1,2
1992 Summer Olympics,23,United States Virgin Islands,ISV,25,0,0,0,0
1992 Summer Olympics,23,Italy,ITA,324,22,10,14,46
1992 Summer Olympics,23,British Virgin Islands,IVB,4,0,0,0,0
1992 Summer Olympics,23,Jamaica,JAM,36,0,3,1,4
1992 Summer Olympics,23,Jordan,JOR,7,0,0,0,0
1992 Summer Olympics,23,Japan,JPN,270,3,8,36,47
1992 Summer Olympics,23,Kenya,KEN,49,2,4,2,8
1992 Summer Olympics,23,Republic of Korea,KOR,244,31,5,16,52
1992 Summer Olympics,23,Kingdom of Saudi Arabia,KSA,9,0,0,0,0
1992 Summer Olympics,23,Kuwait,KUW,36,0,0,0,0
1992 Summer Olympics,23,Lao People's Democratic Republic,LAO,6,0,0,0,0
1992 Summer Olympics,23,Latvia,LAT,34,0,2,1,3
1992 Summer Olympics,23,Libya,LBA,5,0,0,0,0
1992 Summer Olympics,23,Lebanon,LBN,12,0,0,0,0
1992 Summer Olympics,23,Lesotho,LES,6,0,0,0,0
1992 Summer Olympics,23,Liechtenstein,LIE,7,0,0,0,0
1992 Summer Olympics,23,Lithuania,LTU,47,1,0,12,13
1992 Summer Olympics,23,Luxembourg,LUX,6,0,0,0,0
1992 Summer Olympics,23,Madagascar,MAD,13,0,0,0,0
1992 Summer Olympics,23,Morocco,MAR,51,1,1,1,3
1992 Summer Olympics,23,Malaysia,MAS,28,0,0,2,2
1992 Summer Olympics,23,Malawi,MAW,4,0,0,0,0
1992 Summer Olympics,23,Maldives,MDV,7,0,0,0,0
1992 Summer Olympics,23,Mexico,MEX,132,0,1,0,1
1992 Summer Olympics,23,Mongolia,MGL,33,0,0,2,2
1992 Summer Olympics,23,Mali,MLI,5,0,0,0,0
1992 Summer Olympics,23,Malta,MLT,6,0,0,0,0
1992 Summer Olympics,23,Monaco,MON,2,0,0,0,0
1992 Summer Olympics,23,Mozambique,MOZ,6,0,0,0,0
1992 Summer Olympics,23,Mauritius,MRI,13,0,0,0,0
1992 Summer Olympics,23,Mauritania,MTN,6,0,0,0,0
1992 Summer Olympics,23,Myanmar,MYA,4,0,0,0,0
1992 Summer Olympics,23,Namibia,NAM,6,0,2,0,2
1992 Summer Olympics,23,Nicaragua,NCA,8,0,0,0,0
1992 Summer Olympics,23,Netherlands,NED,213,5,20,8,33
1992 Summer Olympics,23,Nepal,NEP,3,0,0,0,0
1992 Summer Olympics,23,Nigeria,NGR,57,0,7,4,11
1992 Summer Olympics,23,Niger,NIG,3,0,0,0,0
1992 Summer Olympics,23,Norway,NOR,85,2,22,1,25
1992 Summer Olympics,23,New Zealand,NZL,137,1,9,5,15
1992 Summer Olympics,23,Oman,OMA,5,0,0,0,0
1992 Summer Olympics,23,Pakistan,PAK,27,0,0,16,16
1992 Summer Olympics,23,Panama,PAN,5,0,0,0,0
1992 Summer Olympics,23,Paraguay,PAR,30,0,0,0,0
1992 Summer Olympics,23,Peru,PER,16,0,1,0,1
1992 Summer Olympics,23,Philippines,PHI,32,0,0,1,1
1992 Summer Olympics,23,Papua New Guinea,PNG,13,0,0,0,0
1992 Summer Olympics,23,Poland,POL,205,5,26,19,50
1992 Summer Olympics,23,Portugal,POR,100,0,0,0,0
1992 Summer Olympics,23,Democratic People's Republic of Korea,PRK,64,4,0,6,10
1992 Summer Olympics,23,Puerto Rico,PUR,75,0,0,1,1
1992 Summer Olympics,23,Qatar,QAT,31,0,0,1,1
1992 Summer Olympics,23,Romania,ROU,173,8,31,14,53
1992 Summer Olympics,23,South Africa,RSA,93,0,3,0,3
1992 Summer Olympics,23,Rwanda,RWA,10,0,0,0,0
1992 Summer Olympics,23,Samoa,SAM,5,0,0,0,0
1992 Summer Olympics,23,Senegal,SEN,21,0,0,0,0
1992 Summer Olympics,23,Seychelles,SEY,11,0,0,0,0
1992 Summer Olympics,23,Singapore,SGP,14,0,0,0,0
1992 Summer Olympics,23,Sierra Leone,SLE,11,0,0,0,0
1992 Summer Olympics,23,Slovenia,SLO,35,0,0,6,6
1992 Summer Olympics,23,San Marino,SMR,17,0,0,0,0
1992 Summer Olympics,23,Solomon Islands,SOL,1,0,0,0,0
1992 Summer Olympics,23,Sri Lanka,SRI,11,0,0,0,0
1992 Summer Olympics,23,Sudan,SUD,6,0,0,0,0
1992 Summer Olympics,23,Switzerland,SUI,115,1,0,0,1
1992 Summer Olympics,23,Suriname,SUR,6,0,0,1,1
1992 Summer Olympics,23,Sweden,SWE,193,1,27,7,35
1992 Summer Olympics,23,Eswatini,SWZ,6,0,0,0,0
1992 Summer Olympics,23,Syrian Arab Republic,SYR,9,0,0,0,0
1992 Summer Olympics,23,United Republic of Tanzania,TAN,9,0,0,0,0
1992 Summer Olympics,23,Czechoslovakia,TCH,209,4,3,1,8
1992 Summer Olympics,23,Tonga,TGA,5,0,0,0,0
1992 Summer Olympics,23,Thailand,THA,46,0,0,1,1
1992 Summer Olympics,23,Togo,TOG,6,0,0,0,0
1992 Summer Olympics,23,Chinese Taipei,TPE,37,0,20,0,20
1992 Summer Olympics,23,Trinidad and Tobago,TTO,7,0,0,0,0
1992 Summer Olympics,23,Tunisia,TUN,14,0,0,0,0
1992 Summer Olympics,23,Türkiye,TUR,47,2,2,2,6
1992 Summer Olympics,23,United Arab Emirates,UAE,14,0,0,0,0
1992 Summer Olympics,23,Uganda,UGA,8,0,0,0,0
1992 Summer Olympics,23,Uruguay,URU,23,0,0,0,0
1992 Summer Olympics,23,United States,USA,574,89,50,85,224
1992 Summer Olympics,23,Vanuatu,VAN,6,0,0,0,0
1992 Summer Olympics,23,Venezuela,VEN,34,0,0,0,0
1992 Summer Olympics,23,Vietnam,VIE,7,0,0,0,0
1992 Summer Olympics,23,Saint Vincent and the Grenadines,VIN,6,0,0,0,0
1992 Summer Olympics,23,Yemen,YEM,9,0,0,0,0
1992 Summer Olympics,23,Zambia,ZAM,9,0,0,0,0
1992 Summer Olympics,23,Zimbabwe,ZIM,19,0,0,0,0
1992 Winter Olympics,44,Netherlands Antilles,AHO,2,0,0,0,0
1992 Winter Olympics,44,Algeria,ALG,4,0,0,0,0
1992 Winter Olympics,44,Andorra,AND,5,0,0,0,0
1992 Winter Olympics,44,Argentina,ARG,21,0,0,0,0
1992 Winter Olympics,44,Australia,AUS,34,0,0,0,0
1992 Winter Olympics,44,Austria,AUT,65,9,10,10,29
1992 Winter Olympics,44,Belgium,BEL,6,0,0,0,0
1992 Winter Olympics,44,Bermuda,BER,1,0,0,0,0
1992 Winter Olympics,44,Bolivia,BOL,5,0,0,0,0
1992 Winter Olympics,44,Brazil,BRA,7,0,0,0,0
1992 Winter Olympics,44,Bulgaria,BUL,30,0,0,0,0
1992 Winter Olympics,44,Canada,CAN,132,6,29,3,38
1992 Winter Olympics,44,Chile,CHI,8,0,0,0,0
1992 Winter Olympics,44,People's Republic of China,CHN,33,0,3,0,3
1992 Winter Olympics,44,Costa Rica,CRC,4,0,0,0,0
1992 Winter Olympics,44,Croatia,CRO,4,0,0,0,0
1992 Winter Olympics,44,Cyprus,CYP,5,0,0,0,0
1992 Winter Olympics,44,Denmark,DEN,11,0,0,0,0
1992 Winter Olympics,44,Spain,ESP,18,0,0,1,1
1992 Winter Olympics,44,Estonia,EST,20,0,0,0,0
1992 Winter Olympics,44,Unified Team,EUN,135,36,10,15,61
1992 Winter Olympics,44,Finland,FIN,69,6,1,6,13
1992 Winter Olympics,44,France,FRA,133,5,6,1,12
1992 Winter Olympics,44,Great Britain,GBR,69,0,0,0,0
1992 Winter Olympics,44,Germany,GER,122,14,17,7,38
1992 Winter Olympics,44,Greece,GRE,9,0,0,0,0
1992 Winter Olympics,44,Honduras,HON,1,0,0,0,0
1992 Winter Olympics,44,Hungary,HUN,24,0,0,0,0
1992 Winter Olympics,44,India,IND,2,0,0,0,0
1992 Winter Olympics,44,Ireland,IRL,4,0,0,0,0
1992 Winter Olympics,44,Iceland,ISL,5,0,0,0,0
1992 Winter Olympics,44,United States Virgin Islands,ISV,12,0,0,0,0
1992 Winter Olympics,44,Italy,ITA,112,4,9,8,21
1992 Winter Olympics,44,Jamaica,JAM,5,0,0,0,0
1992 Winter Olympics,44,Japan,JPN,70,3,2,8,13
1992 Winter Olympics,44,Republic of Korea,KOR,24,6,1,1,8
1992 Winter Olympics,44,Latvia,LAT,23,0,0,0,0
1992 Winter Olympics,44,Lebanon,LBN,4,0,0,0,0
1992 Winter Olympics,44,Liechtenstein,LIE,7,0,0,0,0
1992 Winter Olympics,44,Lithuania,LTU,6,0,0,0,0
1992 Winter Olympics,44,Luxembourg,LUX,1,0,2,0,2
1992 Winter Olympics,44,Morocco,MAR,12,0,0,0,0
1992 Winter Olympics,44,Mexico,MEX,20,0,0,0,0
1992 Winter Olympics,44,Mongolia,MGL,4,0,0,0,0
1992 Winter Olympics,44,Monaco,MON,5,0,0,0,0
1992 Winter Olympics,44,Netherlands,NED,23,1,1,2,4
1992 Winter Olympics,44,Norway,NOR,95,12,11,5,28
1992 Winter Olympics,44,New Zealand,NZL,12,0,1,0,1
1992 Winter Olympics,44,Philippines,PHI,1,0,0,0,0
1992 Winter Olympics,44,Poland,POL,54,0,0,0,0
1992 Winter Olympics,44,Democratic People's Republic of Korea,PRK,20,0,0,1,1
1992 Winter Olympics,44,Puerto Rico,PUR,6,0,0,0,0
1992 Winter Olympics,44,Romania,ROU,23,0,0,0,0
1992 Winter Olympics,44,Senegal,SEN,2,0,0,0,0
1992 Winter Olympics,44,Slovenia,SLO,28,0,0,0,0
1992 Winter Olympics,44,San Marino,SMR,3,0,0,0,0
1992 Winter Olympics,44,Switzerland,SUI,92,2,0,5,7
1992 Winter Olympics,44,Sweden,SWE,90,1,0,6,7
1992 Winter Olympics,44,Eswatini,SWZ,1,0,0,0,0
1992 Winter Olympics,44,Czechoslovakia,TCH,78,0,0,28,28
1992 Winter Olympics,44,Chinese Taipei,TPE,8,0,0,0,0
1992 Winter Olympics,44,Türkiye,TUR,8,0,0,0,0
1992 Winter Olympics,44,United States,USA,169,5,8,2,15
1992 Winter Olympics,44,Yugoslavia,YUG,25,0,0,0,0
1994 Winter Olympics,45,Andorra,AND,6,0,0,0,0
1994 Winter Olympics,45,Argentina,ARG,10,0,0,0,0
1994 Winter Olympics,45,Armenia,ARM,2,0,0,0,0
1994 Winter Olympics,45,American Samoa,ASA,2,0,0,0,0
1994 Winter Olympics,45,Australia,AUS,26,0,0,5,5
1994 Winter Olympics,45,Austria,AUT,80,2,3,7,12
1994 Winter Olympics,45,Belgium,BEL,5,0,0,0,0
1994 Winter Olympics,45,Bermuda,BER,1,0,0,0,0
1994 Winter Olympics,45,Bosnia and Herzegovina,BIH,10,0,0,0,0
1994 Winter Olympics,45,Belarus,BLR,33,0,2,0,2
1994 Winter Olympics,45,Brazil,BRA,1,0,0,0,0
1994 Winter Olympics,45,Bulgaria,BUL,17,0,0,0,0
1994 Winter Olympics,45,Canada,CAN,100,3,32,5,40
1994 Winter Olympics,45,Chile,CHI,3,0,0,0,0
1994 Winter Olympics,45,People's Republic of China,CHN,26,0,1,2,3
1994 Winter Olympics,45,Croatia,CRO,3,0,0,0,0
1994 Winter Olympics,45,Cyprus,CYP,1,0,0,0,0
1994 Winter Olympics,45,Czechia,CZE,64,0,0,0,0
1994 Winter Olympics,45,Denmark,DEN,4,0,0,0,0
1994 Winter Olympics,45,Spain,ESP,13,0,0,0,0
1994 Winter Olympics,45,Estonia,EST,26,0,0,0,0
1994 Winter Olympics,45,Fiji,FIJ,1,0,0,0,0
1994 Winter Olympics,45,Finland,FIN,62,0,1,30,31
1994 Winter Olympics,45,France,FRA,100,0,1,10,11
1994 Winter Olympics,45,Great Britain,GBR,32,0,0,3,3
1994 Winter Olympics,45,Georgia,GEO,5,0,0,0,0
1994 Winter Olympics,45,Germany,GER,112,18,10,12,40
1994 Winter Olympics,45,Greece,GRE,9,0,0,0,0
1994 Winter Olympics,45,Hungary,HUN,16,0,0,0,0
1994 Winter Olympics,45,Iceland,ISL,5,0,0,0,0
1994 Winter Olympics,45,Israel,ISR,1,0,0,0,0
1994 Winter Olympics,45,United States Virgin Islands,ISV,8,0,0,0,0
1994 Winter Olympics,45,Italy,ITA,105,15,6,12,33
1994 Winter Olympics,45,Jamaica,JAM,4,0,0,0,0
1994 Winter Olympics,45,Japan,JPN,61,3,5,2,10
1994 Winter Olympics,45,Kazakhstan,KAZ,29,1,2,0,3
1994 Winter Olympics,45,Kyrgyzstan,KGZ,1,0,0,0,0
1994 Winter Olympics,45,Republic of Korea,KOR,22,8,1,1,10
1994 Winter Olympics,45,Latvia,LAT,27,0,0,0,0
1994 Winter Olympics,45,Liechtenstein,LIE,10,0,0,0,0
1994 Winter Olympics,45,Lithuania,LTU,6,0,0,0,0
1994 Winter Olympics,45,Luxembourg,LUX,1,0,0,0,0
1994 Winter Olympics,45,Republic of Moldova,MDA,2,0,0,0,0
1994 Winter Olympics,45,Mexico,MEX,1,0,0,0,0
1994 Winter Olympics,45,Mongolia,MGL,1,0,0,0,0
1994 Winter Olympics,45,Monaco,MON,5,0,0,0,0
1994 Winter Olympics,45,Netherlands,NED,22,0,1,3,4
1994 Winter Olympics,45,Norway,NOR,89,10,19,5,34
1994 Winter Olympics,45,New Zealand,NZL,8,0,0,0,0
1994 Winter Olympics,45,Poland,POL,28,0,0,0,0
1994 Winter Olympics,45,Portugal,POR,1,0,0,0,0
1994 Winter Olympics,45,Puerto Rico,PUR,5,0,0,0,0
1994 Winter Olympics,45,Romania,ROU,24,0,0,0,0
1994 Winter Olympics,45,South Africa,RSA,2,0,0,0,0
1994 Winter Olympics,45,Russian Federation,RUS,116,19,13,4,36
1994 Winter Olympics,45,Senegal,SEN,1,0,0,0,0
1994 Winter Olympics,45,Slovenia,SLO,22,0,0,3,3
1994 Winter Olympics,45,San Marino,SMR,3,0,0,0,0
1994 Winter Olympics,45,Switzerland,SUI,59,4,8,4,16
1994 Winter Olympics,45,Slovakia,SVK,42,0,0,0,0
1994 Winter Olympics,45,Sweden,SWE,85,24,1,0,25
1994 Winter Olympics,45,Chinese Taipei,TPE,2,0,0,0,0
1994 Winter Olympics,45,Trinidad and Tobago,TTO,2,0,0,0,0
1994 Winter Olympics,45,Türkiye,TUR,1,0,0,0,0
1994 Winter Olympics,45,Ukraine,UKR,37,1,0,1,2
1994 Winter Olympics,45,United States,USA,150,6,9,6,21
1994 Winter Olympics,45,Uzbekistan,UZB,7,1,0,0,1
1996 Summer Olympics,24,Afghanistan,AFG,2,0,0,0,0
1996 Summer Olympics,24,Netherlands Antilles,AHO,6,0,0,0,0
1996 Summer Olympics,24,Albania,ALB,7,0,0,0,0
1996 Summer Olympics,24,Algeria,ALG,46,2,0,1,3
1996 Summer Olympics,24,Andorra,AND,8,0,0,0,0
1996 Summer Olympics,24,Angola,ANG,32,0,0,0,0
1996 Summer Olympics,24,Antigua and Barbuda,ANT,13,0,0,0,0
1996 Summer Olympics,24,Argentina,ARG,183,0,23,1,24
1996 Summer Olympics,24,Armenia,ARM,32,1,1,0,2
1996 Summer Olympics,24,Aruba,ARU,3,0,0,0,0
1996 Summer Olympics,24,American Samoa,ASA,7,0,0,0,0
1996 Summer Olympics,24,Australia,AUS,425,32,16,84,132
1996 Summer Olympics,24,Austria,AUT,73,0,1,2,3
1996 Summer Olympics,24,Azerbaijan,AZE,23,0,1,0,1
1996 Summer Olympics,24,The Bahamas,BAH,27,0,5,0,5
1996 Summer Olympics,24,Bangladesh,BAN,4,0,0,0,0
1996 Summer Olympics,24,Barbados,BAR,13,0,0,0,0
1996 Summer Olympics,24,Burundi,BDI,7,1,0,0,1
1996 Summer Olympics,24,Belgium,BEL,61,2,2,2,6
1996 Summer Olympics,24,Benin,BEN,5,0,0,0,0
1996 Summer Olympics,24,Bermuda,BER,9,0,0,0,0
1996 Summer Olympics,24,Bhutan,BHU,2,0,0,0,0
1996 Summer Olympics,24,Bosnia and Herzegovina,BIH,9,0,0,0,0
1996 Summer Olympics,24,Belize,BIZ,5,0,0,0,0
1996 Summer Olympics,24,Belarus,BLR,157,1,6,16,23
1996 Summer Olympics,24,Bolivia,BOL,8,0,0,0,0
1996 Summer Olympics,24,Botswana,BOT,7,0,0,0,0
1996 Summer Olympics,24,Brazil,BRA,229,5,15,48,68
1996 Summer Olympics,24,Bahrain,BRN,5,0,0,0,0
1996 Summer Olympics,24,Brunei Darussalam,BRU,1,0,0,0,0
1996 Summer Olympics,24,Bulgaria,BUL,111,3,12,6,21
1996 Summer Olympics,24,Burkina Faso,BUR,6,0,0,0,0
1996 Summer Olympics,24,Central African Republic,CAF,5,0,0,0,0
1996 Summer Olympics,24,Cambodia,CAM,5,0,0,0,0
1996 Summer Olympics,24,Canada,CAN,304,8,30,12,50
1996 Summer Olympics,24,Cayman Islands,CAY,9,0,0,0,0
1996 Summer Olympics,24,Congo,CGO,5,0,0,0,0
1996 Summer Olympics,24,Chad,CHA,4,0,0,0,0
1996 Summer Olympics,24,Chile,CHI,21,0,0,0,0
1996 Summer Olympics,24,People's Republic of China,CHN,305,19,76,17,112
1996 Summer Olympics,24,Côte d'Ivoire,CIV,11,0,0,0,0
1996 Summer Olympics,24,Cameroon,CMR,15,0,0,0,0
1996 Summer Olympics,24,Democratic Republic of the Congo,COD,14,0,0,0,0
1996 Summer Olympics,24,Cook Islands,COK,3,0,0,0,0
1996 Summer Olympics,24,Colombia,COL,48,0,0,0,0
1996 Summer Olympics,24,Comoros,COM,4,0,0,0,0
1996 Summer Olympics,24,Cabo Verde,CPV,4,0,0,0,0
1996 Summer Olympics,24,Costa Rica,CRC,11,1,0,0,1
1996 Summer Olympics,24,Croatia,CRO,85,16,13,0,29
1996 Summer Olympics,24,Cuba,CUB,167,39,8,10,57
1996 Summer Olympics,24,Cyprus,CYP,17,0,0,0,0
1996 Summer Olympics,24,Czechia,CZE,115,4,5,4,13
1996 Summer Olympics,24,Denmark,DEN,124,22,1,1,24
1996 Summer Olympics,24,Djibouti,DJI,5,0,0,0,0
1996 Summer Olympics,24,Dominica,DMA,6,0,0,0,0
1996 Summer Olympics,24,Dominican Republic,DOM,16,0,0,0,0
1996 Summer Olympics,24,Ecuador,ECU,19,1,0,0,1
1996 Summer Olympics,24,Egypt,EGY,29,0,0,0,0
1996 Summer Olympics,24,El Salvador,ESA,8,0,0,0,0
1996 Summer Olympics,24,Spain,ESP,296,24,21,22,67
1996 Summer Olympics,24,Estonia,EST,43,0,0,0,0
1996 Summer Olympics,24,Ethiopia,ETH,18,2,0,1,3
1996 Summer Olympics,24,Fiji,FIJ,17,0,0,0,0
1996 Summer Olympics,24,Finland,FIN,76,1,2,1,4
1996 Summer Olympics,24,France,FRA,306,21,10,20,51
1996 Summer Olympics,24,Gabon,GAB,7,0,0,0,0
1996 Summer Olympics,24,The Gambia,GAM,9,0,0,0,0
1996 Summer Olympics,24,Great Britain,GBR,301,2,15,9,26
1996 Summer Olympics,24,Guinea Bissau,GBS,3,0,0,0,0
1996 Summer Olympics,24,Georgia,GEO,34,0,0,2,2
1996 Summer Olympics,24,Equatorial Guinea,GEQ,5,0,0,0,0
1996 Summer Olympics,24,Germany,GER,474,42,35,47,124
1996 Summer Olympics,24,Ghana,GHA,39,0,0,0,0
1996 Summer Olympics,24,Greece,GRE,121,4,4,0,8
1996 Summer Olympics,24,Grenada,GRN,5,0,0,0,0
1996 Summer Olympics,24,Guatemala,GUA,26,0,0,0,0
1996 Summer Olympics,24,Guinea,GUI,5,0,0,0,0
1996 Summer Olympics,24,Guam,GUM,8,0,0,0,0
1996 Summer Olympics,24,Guyana,GUY,7,0,0,0,0
1996 Summer Olympics,24,Haiti,HAI,7,0,0,0,0
1996 Summer Olympics,24,"Hong Kong, China",HKG,23,1,0,0,1
1996 Summer Olympics,24,Honduras,HON,7,0,0,0,0
1996 Summer Olympics,24,Hungary,HUN,218,8,9,26,43
1996 Summer Olympics,24,Indonesia,INA,40,2,1,3,6
1996 Summer Olympics,24,India,IND,49,0,0,1,1
1996 Summer Olympics,24,Islamic Republic of Iran,IRI,18,1,1,1,3
1996 Summer Olympics,24,Ireland,IRL,78,3,0,1,4
1996 Summer Olympics,24,Iraq,IRQ,3,0,0,0,0
1996 Summer Olympics,24,Iceland,ISL,9,0,0,0,0
1996 Summer Olympics,24,Israel,ISR,25,0,0,1,1
1996 Summer Olympics,24,United States Virgin Islands,ISV,12,0,0,0,0
1996 Summer Olympics,24,Italy,ITA,345,19,24,28,71
1996 Summer Olympics,24,British Virgin Islands,IVB,8,0,0,0,0
1996 Summer Olympics,24,Jamaica,JAM,46,1,3,12,16
1996 Summer Olympics,24,Jordan,JOR,5,0,0,0,0
1996 Summer Olympics,24,Japan,JPN,316,3,26,14,43
1996 Summer Olympics,24,Kazakhstan,KAZ,96,3,4,4,11
1996 Summer Olympics,24,Kenya,KEN,52,1,4,3,8
1996 Summer Olympics,24,Kyrgyzstan,KGZ,33,0,0,0,0
1996 Summer Olympics,24,Republic of Korea,KOR,313,10,49,7,66
1996 Summer Olympics,24,Kingdom of Saudi Arabia,KSA,36,0,0,0,0
1996 Summer Olympics,24,Kuwait,KUW,29,0,0,0,0
1996 Summer Olympics,24,Lao People's Democratic Republic,LAO,5,0,0,0,0
1996 Summer Olympics,24,Latvia,LAT,48,0,1,0,1
1996 Summer Olympics,24,Libya,LBA,5,0,0,0,0
1996 Summer Olympics,24,Lebanon,LBN,1,0,0,0,0
1996 Summer Olympics,24,Liberia,LBR,5,0,0,0,0
1996 Summer Olympics,24,Saint Lucia,LCA,6,0,0,0,0
1996 Summer Olympics,24,Lesotho,LES,9,0,0,0,0
1996 Summer Olympics,24,Liechtenstein,LIE,2,0,0,0,0
1996 Summer Olympics,24,Lithuania,LTU,62,0,0,12,12
1996 Summer Olympics,24,Luxembourg,LUX,6,0,0,0,0
1996 Summer Olympics,24,Madagascar,MAD,11,0,0,0,0
1996 Summer Olympics,24,Morocco,MAR,34,0,0,2,2
1996 Summer Olympics,24,Malaysia,MAS,36,0,2,1,3
1996 Summer Olympics,24,Malawi,MAW,2,0,0,0,0
1996 Summer Olympics,24,Republic of Moldova,MDA,40,0,2,1,3
1996 Summer Olympics,24,Maldives,MDV,6,0,0,0,0
1996 Summer Olympics,24,Mexico,MEX,108,0,0,1,1
1996 Summer Olympics,24,Mongolia,MGL,16,0,0,1,1
1996 Summer Olympics,24,North Macedonia,MKD,11,0,0,0,0
1996 Summer Olympics,24,Mali,MLI,3,0,0,0,0
1996 Summer Olympics,24,Malta,MLT,7,0,0,0,0
1996 Summer Olympics,24,Monaco,MON,3,0,0,0,0
1996 Summer Olympics,24,Mozambique,MOZ,4,0,0,1,1
1996 Summer Olympics,24,Mauritius,MRI,26,0,0,0,0
1996 Summer Olympics,24,Mauritania,MTN,4,0,0,0,0
1996 Summer Olympics,24,Myanmar,MYA,3,0,0,0,0
1996 Summer Olympics,24,Namibia,NAM,8,0,2,0,2
1996 Summer Olympics,24,Nicaragua,NCA,26,0,0,0,0
1996 Summer Olympics,24,Netherlands,NED,240,38,9,26,73
1996 Summer Olympics,24,Nepal,NEP,6,0,0,0,0
1996 Summer Olympics,24,Nigeria,NGR,72,23,4,3,30
1996 Summer Olympics,24,Niger,NIG,3,0,0,0,0
1996 Summer Olympics,24,Norway,NOR,101,2,3,21,26
1996 Summer Olympics,24,Nauru,NRU,3,0,0,0,0
1996 Summer Olympics,24,New Zealand,NZL,95,3,2,4,9
1996 Summer Olympics,24,Oman,OMA,4,0,0,0,0
1996 Summer Olympics,24,Pakistan,PAK,24,0,0,0,0
1996 Summer Olympics,24,Panama,PAN,7,0,0,0,0
1996 Summer Olympics,24,Paraguay,PAR,7,0,0,0,0
1996 Summer Olympics,24,Peru,PER,31,0,0,0,0
1996 Summer Olympics,24,Philippines,PHI,12,0,1,0,1
1996 Summer Olympics,24,Palestine,PLE,1,0,0,0,0
1996 Summer Olympics,24,Papua New Guinea,PNG,11,0,0,0,0
1996 Summer Olympics,24,Poland,POL,166,7,8,7,22
1996 Summer Olympics,24,Portugal,POR,110,1,0,2,3
1996 Summer Olympics,24,Democratic People's Republic of Korea,PRK,24,2,1,2,5
1996 Summer Olympics,24,Puerto Rico,PUR,69,0,0,1,1
1996 Summer Olympics,24,Qatar,QAT,12,0,0,0,0
1996 Summer Olympics,24,Romania,ROU,165,13,10,15,38
1996 Summer Olympics,24,South Africa,RSA,84,3,1,1,5
1996 Summer Olympics,24,Russian Federation,RUS,392,36,45,34,115
1996 Summer Olympics,24,Rwanda,RWA,4,0,0,0,0
1996 Summer Olympics,24,Samoa,SAM,5,0,0,0,0
1996 Summer Olympics,24,Serbia & Montenegro,SCG,68,1,12,13,26
1996 Summer Olympics,24,Senegal,SEN,11,0,0,0,0
1996 Summer Olympics,24,Seychelles,SEY,9,0,0,0,0
1996 Summer Olympics,24,Singapore,SGP,14,0,0,0,0
1996 Summer Olympics,24,Saint Kitts and Nevis,SKN,10,0,0,0,0
1996 Summer Olympics,24,Sierra Leone,SLE,14,0,0,0,0
1996 Summer Olympics,24,Slovenia,SLO,37,0,2,0,2
1996 Summer Olympics,24,San Marino,SMR,7,0,0,0,0
1996 Summer Olympics,24,Solomon Islands,SOL,4,0,0,0,0
1996 Summer Olympics,24,Somalia,SOM,4,0,0,0,0
1996 Summer Olympics,24,Sri Lanka,SRI,9,0,0,0,0
1996 Summer Olympics,24,São Tomé and Príncipe,STP,2,0,0,0,0
1996 Summer Olympics,24,Sudan,SUD,4,0,0,0,0
1996 Summer Olympics,24,Switzerland,SUI,119,5,6,0,11
1996 Summer Olympics,24,Suriname,SUR,7,0,0,0,0
1996 Summer Olympics,24,Slovakia,SVK,71,1,1,1,3
1996 Summer Olympics,24,Sweden,SWE,183,3,23,5,31
1996 Summer Olympics,24,Eswatini,SWZ,6,0,0,0,0
1996 Summer Olympics,24,Syrian Arab Republic,SYR,7,1,0,0,1
1996 Summer Olympics,24,United Republic of Tanzania,TAN,7,0,0,0,0
1996 Summer Olympics,24,Tonga,TGA,5,0,1,0,1
1996 Summer Olympics,24,Thailand,THA,37,1,0,1,2
1996 Summer Olympics,24,Tajikistan,TJK,8,0,0,0,0
1996 Summer Olympics,24,Turkmenistan,TKM,7,0,0,0,0
1996 Summer Olympics,24,Togo,TOG,5,0,0,0,0
1996 Summer Olympics,24,Chinese Taipei,TPE,74,0,1,0,1
1996 Summer Olympics,24,Trinidad and Tobago,TTO,12,0,0,2,2
1996 Summer Olympics,24,Tunisia,TUN,56,0,0,1,1
1996 Summer Olympics,24,Türkiye,TUR,53,4,1,1,6
1996 Summer Olympics,24,United Arab Emirates,UAE,4,0,0,0,0
1996 Summer Olympics,24,Uganda,UGA,10,0,0,1,1
1996 Summer Olympics,24,Ukraine,UKR,234,10,5,19,34
1996 Summer Olympics,24,Uruguay,URU,14,0,0,0,0
1996 Summer Olympics,24,United States,USA,666,163,48,52,263
1996 Summer Olympics,24,Uzbekistan,UZB,71,0,1,1,2
1996 Summer Olympics,24,Vanuatu,VAN,4,0,0,0,0
1996 Summer Olympics,24,Venezuela,VEN,39,0,0,0,0
1996 Summer Olympics,24,Vietnam,VIE,6,0,0,0,0
1996 Summer Olympics,24,Saint Vincent and the Grenadines,VIN,8,0,0,0,0
1996 Summer Olympics,24,Yemen,YEM,5,0,0,0,0
1996 Summer Olympics,24,Zambia,ZAM,8,0,1,0,1
1996 Summer Olympics,24,Zimbabwe,ZIM,13,0,0,0,0
1998 Winter Olympics,46,Andorra,AND,3,0,0,0,0
1998 Winter Olympics,46,Argentina,ARG,2,0,0,0,0
1998 Winter Olympics,46,Armenia,ARM,7,0,0,0,0
1998 Winter Olympics,46,Australia,AUS,24,0,0,1,1
1998 Winter Olympics,46,Austria,AUT,97,3,5,12,20
1998 Winter Olympics,46,Azerbaijan,AZE,4,0,0,0,0
1998 Winter Olympics,46,Belgium,BEL,1,0,0,1,1
1998 Winter Olympics,46,Bermuda,BER,1,0,0,0,0
1998 Winter Olympics,46,Bosnia and Herzegovina,BIH,8,0,0,0,0
1998 Winter Olympics,46,Belarus,BLR,59,0,0,2,2
1998 Winter Olympics,46,Brazil,BRA,1,0,0,0,0
1998 Winter Olympics,46,Bulgaria,BUL,19,1,0,0,1
1998 Winter Olympics,46,Canada,CAN,149,15,28,8,51
1998 Winter Olympics,46,Chile,CHI,3,0,0,0,0
1998 Winter Olympics,46,People's Republic of China,CHN,59,0,10,6,16
1998 Winter Olympics,46,Croatia,CRO,6,0,0,0,0
1998 Winter Olympics,46,Cyprus,CYP,1,0,0,0,0
1998 Winter Olympics,46,Czechia,CZE,63,23,1,1,25
1998 Winter Olympics,46,Denmark,DEN,12,0,5,0,5
1998 Winter Olympics,46,Spain,ESP,12,0,0,0,0
1998 Winter Olympics,46,Estonia,EST,20,0,0,0,0
1998 Winter Olympics,46,Finland,FIN,86,2,7,50,59
1998 Winter Olympics,46,France,FRA,107,2,1,12,15
1998 Winter Olympics,46,Great Britain,GBR,34,0,0,4,4
1998 Winter Olympics,46,Georgia,GEO,4,0,0,0,0
1998 Winter Olympics,46,Germany,GER,127,22,12,10,44
1998 Winter Olympics,46,Greece,GRE,13,0,0,0,0
1998 Winter Olympics,46,Hungary,HUN,17,0,0,0,0
1998 Winter Olympics,46,India,IND,1,0,0,0,0
1998 Winter Olympics,46,Islamic Republic of Iran,IRI,1,0,0,0,0
1998 Winter Olympics,46,Ireland,IRL,6,0,0,0,0
1998 Winter Olympics,46,Iceland,ISL,8,0,0,0,0
1998 Winter Olympics,46,Israel,ISR,3,0,0,0,0
1998 Winter Olympics,46,United States Virgin Islands,ISV,7,0,0,0,0
1998 Winter Olympics,46,Italy,ITA,114,3,9,5,17
1998 Winter Olympics,46,Jamaica,JAM,6,0,0,0,0
1998 Winter Olympics,46,Japan,JPN,157,8,1,4,13
1998 Winter Olympics,46,Kazakhstan,KAZ,60,0,0,2,2
1998 Winter Olympics,46,Kenya,KEN,1,0,0,0,0
1998 Winter Olympics,46,Kyrgyzstan,KGZ,1,0,0,0,0
1998 Winter Olympics,46,Republic of Korea,KOR,38,7,5,2,14
1998 Winter Olympics,46,Latvia,LAT,29,0,0,0,0
1998 Winter Olympics,46,Liechtenstein,LIE,8,0,0,0,0
1998 Winter Olympics,46,Lithuania,LTU,7,0,0,0,0
1998 Winter Olympics,46,Luxembourg,LUX,1,0,0,0,0
1998 Winter Olympics,46,Republic of Moldova,MDA,2,0,0,0,0
1998 Winter Olympics,46,Mongolia,MGL,3,0,0,0,0
1998 Winter Olympics,46,North Macedonia,MKD,3,0,0,0,0
1998 Winter Olympics,46,Monaco,MON,4,0,0,0,0
1998 Winter Olympics,46,Netherlands,NED,23,5,4,2,11
1998 Winter Olympics,46,Norway,NOR,76,16,16,12,44
1998 Winter Olympics,46,New Zealand,NZL,8,0,0,0,0
1998 Winter Olympics,46,Poland,POL,39,0,0,0,0
1998 Winter Olympics,46,Portugal,POR,2,0,0,0,0
1998 Winter Olympics,46,Democratic People's Republic of Korea,PRK,9,0,0,0,0
1998 Winter Olympics,46,Puerto Rico,PUR,6,0,0,0,0
1998 Winter Olympics,46,Romania,ROU,17,0,0,0,0
1998 Winter Olympics,46,South Africa,RSA,2,0,0,0,0
1998 Winter Olympics,46,Russian Federation,RUS,123,14,33,6,53
1998 Winter Olympics,46,Serbia & Montenegro,SCG,2,0,0,0,0
1998 Winter Olympics,46,Slovenia,SLO,34,0,0,0,0
1998 Winter Olympics,46,Switzerland,SUI,69,6,5,3,14
1998 Winter Olympics,46,Slovakia,SVK,39,0,0,0,0
1998 Winter Olympics,46,Sweden,SWE,102,0,2,5,7
1998 Winter Olympics,46,Chinese Taipei,TPE,7,0,0,0,0
1998 Winter Olympics,46,Trinidad and Tobago,TTO,2,0,0,0,0
1998 Winter Olympics,46,Türkiye,TUR,1,0,0,0,0
1998 Winter Olympics,46,Ukraine,UKR,56,0,1,0,1
1998 Winter Olympics,46,Uruguay,URU,1,0,0,0,0
1998 Winter Olympics,46,United States,USA,187,25,4,5,34
1998 Winter Olympics,46,Uzbekistan,UZB,4,0,0,0,0
1998 Winter Olympics,46,Venezuela,VEN,1,0,0,0,0
2000 Summer Olympics,25,Netherlands Antilles,AHO,8,0,0,0,0
2000 Summer Olympics,25,Albania,ALB,4,0,0,0,0
2000 Summer Olympics,25,Algeria,ALG,48,1,1,3,5
2000 Summer Olympics,25,Andorra,AND,5,0,0,0,0
2000 Summer Olympics,25,Angola,ANG,31,0,0,0,0
2000 Summer Olympics,25,Antigua and Barbuda,ANT,3,0,0,0,0
2000 Summer Olympics,25,Argentina,ARG,143,0,17,3,20
2000 Summer Olympics,25,Armenia,ARM,25,0,0,1,1
2000 Summer Olympics,25,Aruba,ARU,5,0,0,0,0
2000 Summer Olympics,25,American Samoa,ASA,4,0,0,0,0
2000 Summer Olympics,25,Australia,AUS,632,60,69,54,183
2000 Summer Olympics,25,Austria,AUT,92,3,1,0,4
2000 Summer Olympics,25,Azerbaijan,AZE,31,2,0,1,3
2000 Summer Olympics,25,The Bahamas,BAH,25,6,0,5,11
2000 Summer Olympics,25,Bangladesh,BAN,5,0,0,0,0
2000 Summer Olympics,25,Barbados,BAR,18,0,0,1,1
2000 Summer Olympics,25,Burundi,BDI,6,0,0,0,0
2000 Summer Olympics,25,Belgium,BEL,68,0,3,4,7
2000 Summer Olympics,25,Benin,BEN,4,0,0,0,0
2000 Summer Olympics,25,Bermuda,BER,6,0,0,0,0
2000 Summer Olympics,25,Bhutan,BHU,2,0,0,0,0
2000 Summer Olympics,25,Bosnia and Herzegovina,BIH,9,0,0,0,0
2000 Summer Olympics,25,Belize,BIZ,2,0,0,0,0
2000 Summer Olympics,25,Belarus,BLR,139,3,8,11,22
2000 Summer Olympics,25,Bolivia,BOL,5,0,0,0,0
2000 Summer Olympics,25,Botswana,BOT,7,0,0,0,0
2000 Summer Olympics,25,Brazil,BRA,210,0,12,36,48
2000 Summer Olympics,25,Bahrain,BRN,4,0,0,0,0
2000 Summer Olympics,25,Brunei Darussalam,BRU,2,0,0,0,0
2000 Summer Olympics,25,Bulgaria,BUL,91,5,6,2,13
2000 Summer Olympics,25,Burkina Faso,BUR,4,0,0,0,0
2000 Summer Olympics,25,Central African Republic,CAF,3,0,0,0,0
2000 Summer Olympics,25,Cambodia,CAM,4,0,0,0,0
2000 Summer Olympics,25,Canada,CAN,296,4,4,23,31
2000 Summer Olympics,25,Cayman Islands,CAY,3,0,0,0,0
2000 Summer Olympics,25,Congo,CGO,5,0,0,0,0
2000 Summer Olympics,25,Chad,CHA,2,0,0,0,0
2000 Summer Olympics,25,Chile,CHI,55,0,0,22,22
2000 Summer Olympics,25,People's Republic of China,CHN,280,39,23,17,79
2000 Summer Olympics,25,Côte d'Ivoire,CIV,14,0,0,0,0
2000 Summer Olympics,25,Cameroon,CMR,35,19,0,0,19
2000 Summer Olympics,25,Democratic Republic of the Congo,COD,2,0,0,0,0
2000 Summer Olympics,25,Cook Islands,COK,2,0,0,0,0
2000 Summer Olympics,25,Colombia,COL,44,1,0,0,1
2000 Summer Olympics,25,Comoros,COM,2,0,0,0,0
2000 Summer Olympics,25,Cabo Verde,CPV,2,0,0,0,0
2000 Summer Olympics,25,Costa Rica,CRC,7,0,0,2,2
2000 Summer Olympics,25,Croatia,CRO,89,1,0,9,10
2000 Summer Olympics,25,Cuba,CUB,234,22,35,12,69
2000 Summer Olympics,25,Cyprus,CYP,22,0,0,0,0
2000 Summer Olympics,25,Czechia,CZE,125,2,3,4,9
2000 Summer Olympics,25,Denmark,DEN,97,18,3,4,25
2000 Summer Olympics,25,Djibouti,DJI,2,0,0,0,0
2000 Summer Olympics,25,Dominica,DMA,4,0,0,0,0
2000 Summer Olympics,25,Dominican Republic,DOM,13,0,0,0,0
2000 Summer Olympics,25,Ecuador,ECU,10,0,0,0,0
2000 Summer Olympics,25,Egypt,EGY,89,0,0,0,0
2000 Summer Olympics,25,Eritrea,ERI,3,0,0,0,0
2000 Summer Olympics,25,El Salvador,ESA,8,0,0,0,0
2000 Summer Olympics,25,Spain,ESP,327,3,24,20,47
2000 Summer Olympics,25,Estonia,EST,33,1,0,2,3
2000 Summer Olympics,25,Ethiopia,ETH,27,4,1,3,8
2000 Summer Olympics,25,Fiji,FIJ,7,0,0,0,0
2000 Summer Olympics,25,Finland,FIN,70,3,1,1,5
2000 Summer Olympics,25,France,FRA,338,22,30,14,66
2000 Summer Olympics,25,Federated States of Micronesia,FSM,5,0,0,0,0
2000 Summer Olympics,25,Gabon,GAB,5,0,0,0,0
2000 Summer Olympics,25,The Gambia,GAM,2,0,0,0,0
2000 Summer Olympics,25,Great Britain,GBR,311,22,20,12,54
2000 Summer Olympics,25,Guinea Bissau,GBS,3,0,0,0,0
2000 Summer Olympics,25,Georgia,GEO,36,0,0,6,6
2000 Summer Olympics,25,Equatorial Guinea,GEQ,4,0,0,0,0
2000 Summer Olympics,25,Germany,GER,429,31,23,69,123
2000 Summer Olympics,25,Ghana,GHA,22,0,0,0,0
2000 Summer Olympics,25,Greece,GRE,141,4,6,8,18
2000 Summer Olympics,25,Grenada,GRN,3,0,0,0,0
2000 Summer Olympics,25,Guatemala,GUA,15,0,0,0,0
2000 Summer Olympics,25,Guinea,GUI,6,0,0,0,0
2000 Summer Olympics,25,Guam,GUM,7,0,0,0,0
2000 Summer Olympics,25,Guyana,GUY,4,0,0,0,0
2000 Summer Olympics,25,Haiti,HAI,5,0,0,0,0
2000 Summer Olympics,25,"Hong Kong, China",HKG,31,0,0,0,0
2000 Summer Olympics,25,Honduras,HON,24,0,0,0,0
2000 Summer Olympics,25,Hungary,HUN,179,25,24,4,53
2000 Summer Olympics,25,Indonesia,INA,47,2,4,2,8
2000 Summer Olympics,25,India,IND,66,0,0,1,1
2000 Summer Olympics,25,IOA,IOA,4,0,0,0,0
2000 Summer Olympics,25,Islamic Republic of Iran,IRI,35,3,0,1,4
2000 Summer Olympics,25,Ireland,IRL,64,0,1,0,1
2000 Summer Olympics,25,Iraq,IRQ,4,0,0,0,0
2000 Summer Olympics,25,Iceland,ISL,18,0,0,1,1
2000 Summer Olympics,25,Israel,ISR,39,0,0,1,1
2000 Summer Olympics,25,United States Virgin Islands,ISV,9,0,0,0,0
2000 Summer Olympics,25,Italy,ITA,367,22,14,29,65
2000 Summer Olympics,25,British Virgin Islands,IVB,1,0,0,0,0
2000 Summer Olympics,25,Jamaica,JAM,48,0,20,3,23
2000 Summer Olympics,25,Jordan,JOR,8,0,0,0,0
2000 Summer Olympics,25,Japan,JPN,273,5,31,8,44
2000 Summer Olympics,25,Kazakhstan,KAZ,130,3,4,0,7
2000 Summer Olympics,25,Kenya,KEN,56,2,3,2,7
2000 Summer Olympics,25,Kyrgyzstan,KGZ,48,0,0,1,1
2000 Summer Olympics,25,Republic of Korea,KOR,288,12,26,35,73
2000 Summer Olympics,25,Kingdom of Saudi Arabia,KSA,18,0,1,1,2
2000 Summer Olympics,25,Kuwait,KUW,35,0,0,1,1
2000 Summer Olympics,25,Lao People's Democratic Republic,LAO,3,0,0,0,0
2000 Summer Olympics,25,Latvia,LAT,45,1,1,1,3
2000 Summer Olympics,25,Libya,LBA,3,0,0,0,0
2000 Summer Olympics,25,Lebanon,LBN,6,0,0,0,0
2000 Summer Olympics,25,Liberia,LBR,8,0,0,0,0
2000 Summer Olympics,25,Saint Lucia,LCA,5,0,0,0,0
2000 Summer Olympics,25,Lesotho,LES,6,0,0,0,0
2000 Summer Olympics,25,Liechtenstein,LIE,2,0,0,0,0
2000 Summer Olympics,25,Lithuania,LTU,61,2,0,15,17
2000 Summer Olympics,25,Luxembourg,LUX,7,0,0,0,0
2000 Summer Olympics,25,Madagascar,MAD,11,0,0,0,0
2000 Summer Olympics,25,Morocco,MAR,60,0,1,4,5
2000 Summer Olympics,25,Malaysia,MAS,40,0,0,0,0
2000 Summer Olympics,25,Malawi,MAW,2,0,0,0,0
2000 Summer Olympics,25,Republic of Moldova,MDA,34,0,1,1,2
2000 Summer Olympics,25,Maldives,MDV,4,0,0,0,0
2000 Summer Olympics,25,Mexico,MEX,80,1,2,3,6
2000 Summer Olympics,25,Mongolia,MGL,20,0,0,0,0
2000 Summer Olympics,25,North Macedonia,MKD,10,0,0,1,1
2000 Summer Olympics,25,Mali,MLI,5,0,0,0,0
2000 Summer Olympics,25,Malta,MLT,7,0,0,0,0
2000 Summer Olympics,25,Monaco,MON,4,0,0,0,0
2000 Summer Olympics,25,Mozambique,MOZ,5,1,0,0,1
2000 Summer Olympics,25,Mauritius,MRI,20,0,0,0,0
2000 Summer Olympics,25,Mauritania,MTN,2,0,0,0,0
2000 Summer Olympics,25,Myanmar,MYA,7,0,0,0,0
2000 Summer Olympics,25,Namibia,NAM,11,0,0,0,0
2000 Summer Olympics,25,Nicaragua,NCA,6,0,0,0,0
2000 Summer Olympics,25,Netherlands,NED,235,27,29,23,79
2000 Summer Olympics,25,Nepal,NEP,5,0,0,0,0
2000 Summer Olympics,25,Nigeria,NGR,94,6,2,0,8
2000 Summer Olympics,25,Niger,NIG,4,0,0,0,0
2000 Summer Olympics,25,Norway,NOR,98,25,4,19,48
2000 Summer Olympics,25,Nauru,NRU,3,0,0,0,0
2000 Summer Olympics,25,New Zealand,NZL,147,1,0,3,4
2000 Summer Olympics,25,Oman,OMA,6,0,0,0,0
2000 Summer Olympics,25,Pakistan,PAK,27,0,0,0,0
2000 Summer Olympics,25,Panama,PAN,6,0,0,0,0
2000 Summer Olympics,25,Paraguay,PAR,5,0,0,0,0
2000 Summer Olympics,25,Peru,PER,22,0,0,0,0
2000 Summer Olympics,25,Philippines,PHI,20,0,0,0,0
2000 Summer Olympics,25,Palestine,PLE,2,0,0,0,0
2000 Summer Olympics,25,Palau,PLW,5,0,0,0,0
2000 Summer Olympics,25,Papua New Guinea,PNG,5,0,0,0,0
2000 Summer Olympics,25,Poland,POL,187,7,10,7,24
2000 Summer Olympics,25,Portugal,POR,62,0,0,2,2
2000 Summer Olympics,25,Democratic People's Republic of Korea,PRK,31,0,1,3,4
2000 Summer Olympics,25,Puerto Rico,PUR,29,0,0,0,0
2000 Summer Olympics,25,Qatar,QAT,17,0,0,1,1
2000 Summer Olympics,25,Romania,ROU,146,27,6,13,46
2000 Summer Olympics,25,South Africa,RSA,135,0,2,3,5
2000 Summer Olympics,25,Russian Federation,RUS,437,66,68,54,188
2000 Summer Olympics,25,Rwanda,RWA,5,0,0,0,0
2000 Summer Olympics,25,Samoa,SAM,5,0,0,0,0
2000 Summer Olympics,25,Serbia & Montenegro,SCG,110,12,1,13,26
2000 Summer Olympics,25,Senegal,SEN,26,0,0,0,0
2000 Summer Olympics,25,Seychelles,SEY,9,0,0,0,0
2000 Summer Olympics,25,Singapore,SGP,14,0,0,0,0
2000 Summer Olympics,25,Saint Kitts and Nevis,SKN,2,0,0,0,0
2000 Summer Olympics,25,Sierra Leone,SLE,3,0,0,0,0
2000 Summer Olympics,25,Slovenia,SLO,74,3,0,0,3
2000 Summer Olympics,25,San Marino,SMR,4,0,0,0,0
2000 Summer Olympics,25,Solomon Islands,SOL,2,0,0,0,0
2000 Summer Olympics,25,Somalia,SOM,2,0,0,0,0
2000 Summer Olympics,25,Sri Lanka,SRI,18,0,1,0,1
2000 Summer Olympics,25,São Tomé and Príncipe,STP,2,0,0,0,0
2000 Summer Olympics,25,Sudan,SUD,3,0,0,0,0
2000 Summer Olympics,25,Switzerland,SUI,103,1,11,2,14
2000 Summer Olympics,25,Suriname,SUR,4,0,0,0,0
2000 Summer Olympics,25,Slovakia,SVK,112,2,3,1,6
2000 Summer Olympics,25,Sweden,SWE,157,4,20,8,32
2000 Summer Olympics,25,Eswatini,SWZ,6,0,0,0,0
2000 Summer Olympics,25,Syrian Arab Republic,SYR,8,0,0,0,0
2000 Summer Olympics,25,United Republic of Tanzania,TAN,4,0,0,0,0
2000 Summer Olympics,25,Tonga,TGA,3,0,0,0,0
2000 Summer Olympics,25,Thailand,THA,52,1,0,2,3
2000 Summer Olympics,25,Tajikistan,TJK,4,0,0,0,0
2000 Summer Olympics,25,Turkmenistan,TKM,8,0,0,0,0
2000 Summer Olympics,25,Togo,TOG,3,0,0,0,0
2000 Summer Olympics,25,Chinese Taipei,TPE,55,0,1,4,5
2000 Summer Olympics,25,Trinidad and Tobago,TTO,19,0,1,1,2
2000 Summer Olympics,25,Tunisia,TUN,48,0,0,0,0
2000 Summer Olympics,25,Türkiye,TUR,58,3,0,2,5
2000 Summer Olympics,25,United Arab Emirates,UAE,4,0,0,0,0
2000 Summer Olympics,25,Uganda,UGA,13,0,0,0,0
2000 Summer Olympics,25,Ukraine,UKR,230,3,20,12,35
2000 Summer Olympics,25,Uruguay,URU,15,0,1,0,1
2000 Summer Olympics,25,United States,USA,603,131,70,52,253
2000 Summer Olympics,25,Uzbekistan,UZB,70,1,1,2,4
2000 Summer Olympics,25,Vanuatu,VAN,3,0,0,0,0
2000 Summer Olympics,25,Venezuela,VEN,50,0,0,0,0
2000 Summer Olympics,25,Vietnam,VIE,7,0,1,0,1
2000 Summer Olympics,25,Saint Vincent and the Grenadines,VIN,4,0,0,0,0
2000 Summer Olympics,25,Yemen,YEM,2,0,0,0,0
2000 Summer Olympics,25,Zambia,ZAM,8,0,0,0,0
2000 Summer Olympics,25,Zimbabwe,ZIM,16,0,0,0,0
2002 Winter Olympics,47,Andorra,AND,3,0,0,0,0
2002 Winter Olympics,47,Argentina,ARG,11,0,0,0,0
2002 Winter Olympics,47,Armenia,ARM,9,0,0,0,0
2002 Winter Olympics,47,Australia,AUS,25,2,0,0,2
2002 Winter Olympics,47,Austria,AUT,92,3,4,13,20
2002 Winter Olympics,47,Azerbaijan,AZE,4,0,0,0,0
2002 Winter Olympics,47,Belgium,BEL,6,0,0,0,0
2002 Winter Olympics,47,Bermuda,BER,1,0,0,0,0
2002 Winter Olympics,47,Bosnia and Herzegovina,BIH,2,0,0,0,0
2002 Winter Olympics,47,Belarus,BLR,64,0,0,1,1
2002 Winter Olympics,47,Brazil,BRA,10,0,0,0,0
2002 Winter Olympics,47,Bulgaria,BUL,24,0,1,2,3
2002 Winter Olympics,47,Canada,CAN,152,53,7,15,75
2002 Winter Olympics,47,Chile,CHI,6,0,0,0,0
2002 Winter Olympics,47,People's Republic of China,CHN,68,2,6,9,17
2002 Winter Olympics,47,Cameroon,CMR,1,0,0,0,0
2002 Winter Olympics,47,Costa Rica,CRC,1,0,0,0,0
2002 Winter Olympics,47,Croatia,CRO,13,3,1,0,4
2002 Winter Olympics,47,Cyprus,CYP,1,0,0,0,0
2002 Winter Olympics,47,Czechia,CZE,78,1,2,0,3
2002 Winter Olympics,47,Denmark,DEN,11,0,0,0,0
2002 Winter Olympics,47,Spain,ESP,7,0,0,0,0
2002 Winter Olympics,47,Estonia,EST,17,1,1,1,3
2002 Winter Olympics,47,Fiji,FIJ,1,0,0,0,0
2002 Winter Olympics,47,Finland,FIN,100,7,5,1,13
2002 Winter Olympics,47,France,FRA,115,5,5,5,15
2002 Winter Olympics,47,Great Britain,GBR,49,5,0,1,6
2002 Winter Olympics,47,Georgia,GEO,4,0,0,0,0
2002 Winter Olympics,47,Germany,GER,157,26,23,12,61
2002 Winter Olympics,47,Greece,GRE,10,0,0,0,0
2002 Winter Olympics,47,"Hong Kong, China",HKG,2,0,0,0,0
2002 Winter Olympics,47,Hungary,HUN,25,0,0,0,0
2002 Winter Olympics,47,India,IND,1,0,0,0,0
2002 Winter Olympics,47,Islamic Republic of Iran,IRI,2,0,0,0,0
2002 Winter Olympics,47,Ireland,IRL,6,0,0,0,0
2002 Winter Olympics,47,Iceland,ISL,6,0,0,0,0
2002 Winter Olympics,47,Israel,ISR,5,0,0,0,0
2002 Winter Olympics,47,United States Virgin Islands,ISV,8,0,0,0,0
2002 Winter Olympics,47,Italy,ITA,109,4,11,6,21
2002 Winter Olympics,47,Jamaica,JAM,2,0,0,0,0
2002 Winter Olympics,47,Japan,JPN,104,0,1,1,2
2002 Winter Olympics,47,Kazakhstan,KAZ,51,0,0,0,0
2002 Winter Olympics,47,Kenya,KEN,1,0,0,0,0
2002 Winter Olympics,47,Kyrgyzstan,KGZ,2,0,0,0,0
2002 Winter Olympics,47,Republic of Korea,KOR,46,6,2,0,8
2002 Winter Olympics,47,Latvia,LAT,48,0,0,0,0
2002 Winter Olympics,47,Lebanon,LBN,2,0,0,0,0
2002 Winter Olympics,47,Liechtenstein,LIE,9,0,0,0,0
2002 Winter Olympics,47,Lithuania,LTU,8,0,0,0,0
2002 Winter Olympics,47,Republic of Moldova,MDA,5,0,0,0,0
2002 Winter Olympics,47,Mexico,MEX,3,0,0,0,0
2002 Winter Olympics,47,Mongolia,MGL,4,0,0,0,0
2002 Winter Olympics,47,North Macedonia,MKD,3,0,0,0,0
2002 Winter Olympics,47,Monaco,MON,5,0,0,0,0
2002 Winter Olympics,47,Netherlands,NED,27,3,5,0,8
2002 Winter Olympics,47,Nepal,NEP,1,0,0,0,0
2002 Winter Olympics,47,Norway,NOR,79,23,11,7,41
2002 Winter Olympics,47,New Zealand,NZL,10,0,0,0,0
2002 Winter Olympics,47,Poland,POL,27,0,1,1,2
2002 Winter Olympics,47,Romania,ROU,21,0,0,0,0
2002 Winter Olympics,47,South Africa,RSA,1,0,0,0,0
2002 Winter Olympics,47,Russian Federation,RUS,155,6,5,29,40
2002 Winter Olympics,47,Serbia & Montenegro,SCG,6,0,0,0,0
2002 Winter Olympics,47,Slovenia,SLO,40,0,0,4,4
2002 Winter Olympics,47,San Marino,SMR,1,0,0,0,0
2002 Winter Olympics,47,Switzerland,SUI,111,3,7,14,24
2002 Winter Olympics,47,Slovakia,SVK,49,0,0,0,0
2002 Winter Olympics,47,Sweden,SWE,104,0,2,24,26
2002 Winter Olympics,47,Thailand,THA,1,0,0,0,0
2002 Winter Olympics,47,Tajikistan,TJK,1,0,0,0,0
2002 Winter Olympics,47,Chinese Taipei,TPE,6,0,0,0,0
2002 Winter Olympics,47,Trinidad and Tobago,TTO,3,0,0,0,0
2002 Winter Olympics,47,Türkiye,TUR,3,0,0,0,0
2002 Winter Olympics,47,Ukraine,UKR,69,0,0,0,0
2002 Winter Olympics,47,United States,USA,204,11,58,15,84
2002 Winter Olympics,47,Uzbekistan,UZB,6,0,0,0,0
2002 Winter Olympics,47,Venezuela,VEN,4,0,0,0,0
2004 Summer Olympics,26,Afghanistan,AFG,5,0,0,0,0
2004 Summer Olympics,26,Netherlands Antilles,AHO,3,0,0,0,0
2004 Summer Olympics,26,Albania,ALB,7,0,0,0,0
2004 Summer Olympics,26,Algeria,ALG,62,0,0,0,0
2004 Summer Olympics,26,Andorra,AND,6,0,0,0,0
2004 Summer Olympics,26,Angola,ANG,31,0,0,0,0
2004 Summer Olympics,26,Antigua and Barbuda,ANT,5,0,0,0,0
2004 Summer Olympics,26,Argentina,ARG,159,34,0,21,55
2004 Summer Olympics,26,Armenia,ARM,18,0,0,0,0
2004 Summer Olympics,26,Aruba,ARU,4,0,0,0,0
2004 Summer Olympics,26,American Samoa,ASA,3,0,0,0,0
2004 Summer Olympics,26,Australia,AUS,487,49,79,31,159
2004 Summer Olympics,26,Austria,AUT,74,3,4,1,8
2004 Summer Olympics,26,Azerbaijan,AZE,37,1,0,4,5
2004 Summer Olympics,26,The Bahamas,BAH,23,1,0,1,2
2004 Summer Olympics,26,Bangladesh,BAN,4,0,0,0,0
2004 Summer Olympics,26,Barbados,BAR,10,0,0,0,0
2004 Summer Olympics,26,Burundi,BDI,7,0,0,0,0
2004 Summer Olympics,26,Belgium,BEL,52,1,0,2,3
2004 Summer Olympics,26,Benin,BEN,4,0,0,0,0
2004 Summer Olympics,26,Bermuda,BER,10,0,0,0,0
2004 Summer Olympics,26,Bhutan,BHU,2,0,0,0,0
2004 Summer Olympics,26,Bosnia and Herzegovina,BIH,9,0,0,0,0
2004 Summer Olympics,26,Belize,BIZ,2,0,0,0,0
2004 Summer Olympics,26,Belarus,BLR,153,2,5,8,15
2004 Summer Olympics,26,Bolivia,BOL,7,0,0,0,0
2004 Summer Olympics,26,Botswana,BOT,11,0,0,0,0
2004 Summer Olympics,26,Brazil,BRA,248,18,21,3,42
2004 Summer Olympics,26,Bahrain,BRN,10,0,0,0,0
2004 Summer Olympics,26,Brunei Darussalam,BRU,1,0,0,0,0
2004 Summer Olympics,26,Bulgaria,BUL,96,2,1,14,17
2004 Summer Olympics,26,Burkina Faso,BUR,5,0,0,0,0
2004 Summer Olympics,26,Central African Republic,CAF,4,0,0,0,0
2004 Summer Olympics,26,Cambodia,CAM,4,0,0,0,0
2004 Summer Olympics,26,Canada,CAN,267,3,10,4,17
2004 Summer Olympics,26,Cayman Islands,CAY,5,0,0,0,0
2004 Summer Olympics,26,Congo,CGO,6,0,0,0,0
2004 Summer Olympics,26,Chad,CHA,2,0,0,0,0
2004 Summer Olympics,26,Chile,CHI,22,3,0,1,4
2004 Summer Olympics,26,People's Republic of China,CHN,391,52,27,15,94
2004 Summer Olympics,26,Côte d'Ivoire,CIV,5,0,0,0,0
2004 Summer Olympics,26,Cameroon,CMR,19,1,0,0,1
2004 Summer Olympics,26,Democratic Republic of the Congo,COD,4,0,0,0,0
2004 Summer Olympics,26,Cook Islands,COK,3,0,0,0,0
2004 Summer Olympics,26,Colombia,COL,55,0,0,2,2
2004 Summer Olympics,26,Comoros,COM,3,0,0,0,0
2004 Summer Olympics,26,Cabo Verde,CPV,3,0,0,0,0
2004 Summer Olympics,26,Costa Rica,CRC,27,0,0,0,0
2004 Summer Olympics,26,Croatia,CRO,81,15,3,3,21
2004 Summer Olympics,26,Cuba,CUB,152,32,8,22,62
2004 Summer Olympics,26,Cyprus,CYP,20,0,0,0,0
2004 Summer Olympics,26,Czechia,CZE,142,1,6,6,13
2004 Summer Olympics,26,Denmark,DEN,92,19,1,9,29
2004 Summer Olympics,26,Dominica,DMA,2,0,0,0,0
2004 Summer Olympics,26,Dominican Republic,DOM,33,1,0,0,1
2004 Summer Olympics,26,Ecuador,ECU,16,0,0,0,0
2004 Summer Olympics,26,Egypt,EGY,97,1,1,3,5
2004 Summer Olympics,26,Eritrea,ERI,4,0,0,1,1
2004 Summer Olympics,26,El Salvador,ESA,7,0,0,0,0
2004 Summer Olympics,26,Spain,ESP,319,4,17,9,30
2004 Summer Olympics,26,Estonia,EST,42,0,1,2,3
2004 Summer Olympics,26,Ethiopia,ETH,26,2,3,2,7
2004 Summer Olympics,26,Fiji,FIJ,8,0,0,0,0
2004 Summer Olympics,26,Finland,FIN,53,0,2,0,2
2004 Summer Olympics,26,France,FRA,314,21,10,24,55
2004 Summer Olympics,26,Federated States of Micronesia,FSM,5,0,0,0,0
2004 Summer Olympics,26,Gabon,GAB,5,0,0,0,0
2004 Summer Olympics,26,The Gambia,GAM,2,0,0,0,0
2004 Summer Olympics,26,Great Britain,GBR,268,19,25,15,59
2004 Summer Olympics,26,Guinea Bissau,GBS,3,0,0,0,0
2004 Summer Olympics,26,Georgia,GEO,33,2,2,0,4
2004 Summer Olympics,26,Equatorial Guinea,GEQ,2,0,0,0,0
2004 Summer Olympics,26,Germany,GER,453,41,45,69,155
2004 Summer Olympics,26,Ghana,GHA,31,0,0,0,0
2004 Summer Olympics,26,Greece,GRE,443,8,18,5,31
2004 Summer Olympics,26,Grenada,GRN,5,0,0,0,0
2004 Summer Olympics,26,Guatemala,GUA,18,0,0,0,0
2004 Summer Olympics,26,Guinea,GUI,3,0,0,0,0
2004 Summer Olympics,26,Guam,GUM,4,0,0,0,0
2004 Summer Olympics,26,Guyana,GUY,4,0,0,0,0
2004 Summer Olympics,26,Haiti,HAI,8,0,0,0,0
2004 Summer Olympics,26,"Hong Kong, China",HKG,32,0,2,0,2
2004 Summer Olympics,26,Honduras,HON,5,0,0,0,0
2004 Summer Olympics,26,Hungary,HUN,212,24,12,4,40
2004 Summer Olympics,26,Indonesia,INA,38,1,1,3,5
2004 Summer Olympics,26,India,IND,74,0,1,0,1
2004 Summer Olympics,26,Islamic Republic of Iran,IRI,37,2,2,2,6
2004 Summer Olympics,26,Ireland,IRL,46,0,0,0,0
2004 Summer Olympics,26,Iraq,IRQ,27,0,0,0,0
2004 Summer Olympics,26,Iceland,ISL,26,0,0,0,0
2004 Summer Olympics,26,Israel,ISR,36,1,0,1,2
2004 Summer Olympics,26,United States Virgin Islands,ISV,6,0,0,0,0
2004 Summer Olympics,26,Italy,ITA,371,24,41,44,109
2004 Summer Olympics,26,British Virgin Islands,IVB,1,0,0,0,0
2004 Summer Olympics,26,Jamaica,JAM,51,8,1,7,16
2004 Summer Olympics,26,Jordan,JOR,8,0,0,0,0
2004 Summer Olympics,26,Japan,JPN,321,21,20,53,94
2004 Summer Olympics,26,Kazakhstan,KAZ,116,1,4,3,8
2004 Summer Olympics,26,Kenya,KEN,46,1,4,2,7
2004 Summer Olympics,26,Kyrgyzstan,KGZ,29,0,0,0,0
2004 Summer Olympics,26,Kiribati,KIR,3,0,0,0,0
2004 Summer Olympics,26,Republic of Korea,KOR,272,14,28,10,52
2004 Summer Olympics,26,Kingdom of Saudi Arabia,KSA,17,0,0,0,0
2004 Summer Olympics,26,Kuwait,KUW,11,0,0,0,0
2004 Summer Olympics,26,Lao People's Democratic Republic,LAO,5,0,0,0,0
2004 Summer Olympics,26,Latvia,LAT,32,0,4,0,4
2004 Summer Olympics,26,Libya,LBA,8,0,0,0,0
2004 Summer Olympics,26,Lebanon,LBN,5,0,0,0,0
2004 Summer Olympics,26,Liberia,LBR,2,0,0,0,0
2004 Summer Olympics,26,Saint Lucia,LCA,2,0,0,0,0
2004 Summer Olympics,26,Lesotho,LES,3,0,0,0,0
2004 Summer Olympics,26,Liechtenstein,LIE,1,0,0,0,0
2004 Summer Olympics,26,Lithuania,LTU,59,1,2,0,3
2004 Summer Olympics,26,Luxembourg,LUX,10,0,0,0,0
2004 Summer Olympics,26,Madagascar,MAD,9,0,0,0,0
2004 Summer Olympics,26,Morocco,MAR,62,2,1,0,3
2004 Summer Olympics,26,Malaysia,MAS,26,0,0,0,0
2004 Summer Olympics,26,Malawi,MAW,4,0,0,0,0
2004 Summer Olympics,26,Republic of Moldova,MDA,33,0,0,0,0
2004 Summer Olympics,26,Maldives,MDV,4,0,0,0,0
2004 Summer Olympics,26,Mexico,MEX,122,0,3,1,4
2004 Summer Olympics,26,Mongolia,MGL,20,0,0,1,1
2004 Summer Olympics,26,North Macedonia,MKD,10,0,0,0,0
2004 Summer Olympics,26,Mali,MLI,26,0,0,0,0
2004 Summer Olympics,26,Malta,MLT,7,0,0,0,0
2004 Summer Olympics,26,Monaco,MON,3,0,0,0,0
2004 Summer Olympics,26,Mozambique,MOZ,4,0,0,0,0
2004 Summer Olympics,26,Mauritius,MRI,9,0,0,0,0
2004 Summer Olympics,26,Mauritania,MTN,2,0,0,0,0
2004 Summer Olympics,26,Myanmar,MYA,2,0,0,0,0
2004 Summer Olympics,26,Namibia,NAM,8,0,0,0,0
2004 Summer Olympics,26,Nicaragua,NCA,5,0,0,0,0
2004 Summer Olympics,26,Netherlands,NED,214,4,51,22,77
2004 Summer Olympics,26,Nepal,NEP,6,0,0,0,0
2004 Summer Olympics,26,Nigeria,NGR,85,0,0,13,13
2004 Summer Olympics,26,Niger,NIG,4,0,0,0,0
2004 Summer Olympics,26,Norway,NOR,52,5,0,2,7
2004 Summer Olympics,26,Nauru,NRU,3,0,0,0,0
2004 Summer Olympics,26,New Zealand,NZL,148,4,2,0,6
2004 Summer Olympics,26,Oman,OMA,2,0,0,0,0
2004 Summer Olympics,26,Pakistan,PAK,26,0,0,0,0
2004 Summer Olympics,26,Panama,PAN,4,0,0,0,0
2004 Summer Olympics,26,Paraguay,PAR,27,0,22,0,22
2004 Summer Olympics,26,Peru,PER,12,0,0,0,0
2004 Summer Olympics,26,Philippines,PHI,16,0,0,0,0
2004 Summer Olympics,26,Palestine,PLE,3,0,0,0,0
2004 Summer Olympics,26,Palau,PLW,4,0,0,0,0
2004 Summer Olympics,26,Papua New Guinea,PNG,4,0,0,0,0
2004 Summer Olympics,26,Poland,POL,199,4,2,6,12
2004 Summer Olympics,26,Portugal,POR,84,0,2,1,3
2004 Summer Olympics,26,Democratic People's Republic of Korea,PRK,36,0,4,1,5
2004 Summer Olympics,26,Puerto Rico,PUR,43,0,0,0,0
2004 Summer Olympics,26,Qatar,QAT,15,0,0,0,0
2004 Summer Olympics,26,Romania,ROU,109,23,5,11,39
2004 Summer Olympics,26,South Africa,RSA,106,4,3,3,10
2004 Summer Olympics,26,Russian Federation,RUS,455,48,51,96,195
2004 Summer Olympics,26,Rwanda,RWA,5,0,0,0,0
2004 Summer Olympics,26,Samoa,SAM,3,0,0,0,0
2004 Summer Olympics,26,Serbia & Montenegro,SCG,91,0,14,0,14
2004 Summer Olympics,26,Senegal,SEN,17,0,0,0,0
2004 Summer Olympics,26,Seychelles,SEY,9,0,0,0,0
2004 Summer Olympics,26,Singapore,SGP,16,0,0,0,0
2004 Summer Olympics,26,Saint Kitts and Nevis,SKN,2,0,0,0,0
2004 Summer Olympics,26,Sierra Leone,SLE,2,0,0,0,0
2004 Summer Olympics,26,Slovenia,SLO,79,0,2,3,5
2004 Summer Olympics,26,San Marino,SMR,5,0,0,0,0
2004 Summer Olympics,26,Solomon Islands,SOL,2,0,0,0,0
2004 Summer Olympics,26,Somalia,SOM,2,0,0,0,0
2004 Summer Olympics,26,Sri Lanka,SRI,7,0,0,0,0
2004 Summer Olympics,26,São Tomé and Príncipe,STP,2,0,0,0,0
2004 Summer Olympics,26,Sudan,SUD,5,0,0,0,0
2004 Summer Olympics,26,Switzerland,SUI,99,1,2,4,7
2004 Summer Olympics,26,Suriname,SUR,4,0,0,0,0
2004 Summer Olympics,26,Slovakia,SVK,64,3,2,5,10
2004 Summer Olympics,26,Sweden,SWE,120,5,5,2,12
2004 Summer Olympics,26,Eswatini,SWZ,3,0,0,0,0
2004 Summer Olympics,26,Syrian Arab Republic,SYR,6,0,0,1,1
2004 Summer Olympics,26,United Republic of Tanzania,TAN,8,0,0,0,0
2004 Summer Olympics,26,Tonga,TGA,5,0,0,0,0
2004 Summer Olympics,26,Thailand,THA,43,3,1,4,8
2004 Summer Olympics,26,Tajikistan,TJK,9,0,0,0,0
2004 Summer Olympics,26,Turkmenistan,TKM,9,0,0,0,0
2004 Summer Olympics,26,Timor-Leste,TLS,2,0,0,0,0
2004 Summer Olympics,26,Togo,TOG,3,0,0,0,0
2004 Summer Olympics,26,Chinese Taipei,TPE,88,2,4,3,9
2004 Summer Olympics,26,Trinidad and Tobago,TTO,23,0,0,1,1
2004 Summer Olympics,26,Tunisia,TUN,62,0,0,0,0
2004 Summer Olympics,26,Türkiye,TUR,65,3,3,4,10
2004 Summer Olympics,26,United Arab Emirates,UAE,4,1,0,0,1
2004 Summer Olympics,26,Uganda,UGA,11,0,0,0,0
2004 Summer Olympics,26,Ukraine,UKR,243,8,8,31,47
2004 Summer Olympics,26,Uruguay,URU,15,0,0,0,0
2004 Summer Olympics,26,United States,USA,544,123,76,72,271
2004 Summer Olympics,26,Uzbekistan,UZB,70,2,1,2,5
2004 Summer Olympics,26,Vanuatu,VAN,2,0,0,0,0
2004 Summer Olympics,26,Venezuela,VEN,48,0,0,2,2
2004 Summer Olympics,26,Vietnam,VIE,11,0,0,0,0
2004 Summer Olympics,26,Saint Vincent and the Grenadines,VIN,3,0,0,0,0
2004 Summer Olympics,26,Yemen,YEM,3,0,0,0,0
2004 Summer Olympics,26,Zambia,ZAM,6,0,0,0,0
2004 Summer Olympics,26,Zimbabwe,ZIM,12,1,1,1,3
2006 Winter Olympics,49,Albania,ALB,1,0,0,0,0
2006 Winter Olympics,49,Algeria,ALG,2,0,0,0,0
2006 Winter Olympics,49,Andorra,AND,3,0,0,0,0
2006 Winter Olympics,49,Argentina,ARG,9,0,0,0,0
2006 Winter Olympics,49,Armenia,ARM,5,0,0,0,0
2006 Winter Olympics,49,Australia,AUS,40,1,0,1,2
2006 Winter Olympics,49,Austria,AUT,73,16,7,7,30
2006 Winter Olympics,49,Azerbaijan,AZE,2,0,0,0,0
2006 Winter Olympics,49,Belgium,BEL,4,0,0,0,0
2006 Winter Olympics,49,Bermuda,BER,1,0,0,0,0
2006 Winter Olympics,49,Bosnia and Herzegovina,BIH,6,0,0,0,0
2006 Winter Olympics,49,Belarus,BLR,28,0,1,0,1
2006 Winter Olympics,49,Brazil,BRA,9,0,0,0,0
2006 Winter Olympics,49,Bulgaria,BUL,21,0,1,0,1
2006 Winter Olympics,49,Canada,CAN,192,30,28,11,69
2006 Winter Olympics,49,Chile,CHI,9,0,0,0,0
2006 Winter Olympics,49,People's Republic of China,CHN,75,2,5,6,13
2006 Winter Olympics,49,Costa Rica,CRC,1,0,0,0,0
2006 Winter Olympics,49,Croatia,CRO,23,1,2,0,3
2006 Winter Olympics,49,Cyprus,CYP,1,0,0,0,0
2006 Winter Olympics,49,Czechia,CZE,84,1,2,25,28
2006 Winter Olympics,49,Denmark,DEN,5,0,0,0,0
2006 Winter Olympics,49,Spain,ESP,16,0,0,0,0
2006 Winter Olympics,49,Estonia,EST,26,3,0,0,3
2006 Winter Olympics,49,Ethiopia,ETH,1,0,0,0,0
2006 Winter Olympics,49,Finland,FIN,92,0,36,7,43
2006 Winter Olympics,49,France,FRA,84,3,2,10,15
2006 Winter Olympics,49,Great Britain,GBR,39,0,1,0,1
2006 Winter Olympics,49,Georgia,GEO,3,0,0,0,0
2006 Winter Olympics,49,Germany,GER,155,23,25,6,54
2006 Winter Olympics,49,Greece,GRE,5,0,0,0,0
2006 Winter Olympics,49,"Hong Kong, China",HKG,1,0,0,0,0
2006 Winter Olympics,49,Hungary,HUN,19,0,0,0,0
2006 Winter Olympics,49,India,IND,4,0,0,0,0
2006 Winter Olympics,49,Islamic Republic of Iran,IRI,2,0,0,0,0
2006 Winter Olympics,49,Ireland,IRL,4,0,0,0,0
2006 Winter Olympics,49,Iceland,ISL,5,0,0,0,0
2006 Winter Olympics,49,Israel,ISR,5,0,0,0,0
2006 Winter Olympics,49,Italy,ITA,182,12,0,15,27
2006 Winter Olympics,49,Japan,JPN,110,1,0,0,1
2006 Winter Olympics,49,Kazakhstan,KAZ,56,0,0,0,0
2006 Winter Olympics,49,Kenya,KEN,1,0,0,0,0
2006 Winter Olympics,49,Kyrgyzstan,KGZ,1,0,0,0,0
2006 Winter Olympics,49,Republic of Korea,KOR,40,14,3,2,19
2006 Winter Olympics,49,Latvia,LAT,57,0,0,1,1
2006 Winter Olympics,49,Lebanon,LBN,3,0,0,0,0
2006 Winter Olympics,49,Liechtenstein,LIE,5,0,0,0,0
2006 Winter Olympics,49,Lithuania,LTU,7,0,0,0,0
2006 Winter Olympics,49,Luxembourg,LUX,1,0,0,0,0
2006 Winter Olympics,49,Madagascar,MAD,1,0,0,0,0
2006 Winter Olympics,49,Republic of Moldova,MDA,6,0,0,0,0
2006 Winter Olympics,49,Mongolia,MGL,2,0,0,0,0
2006 Winter Olympics,49,North Macedonia,MKD,3,0,0,0,0
2006 Winter Olympics,49,Monaco,MON,4,0,0,0,0
2006 Winter Olympics,49,Netherlands,NED,33,3,2,8,13
2006 Winter Olympics,49,Nepal,NEP,1,0,0,0,0
2006 Winter Olympics,49,Norway,NOR,69,2,9,12,23
2006 Winter Olympics,49,New Zealand,NZL,17,0,0,0,0
2006 Winter Olympics,49,Poland,POL,45,0,1,1,2
2006 Winter Olympics,49,Portugal,POR,1,0,0,0,0
2006 Winter Olympics,49,Democratic People's Republic of Korea,PRK,6,0,0,0,0
2006 Winter Olympics,49,Romania,ROU,25,0,0,0,0
2006 Winter Olympics,49,South Africa,RSA,3,0,0,0,0
2006 Winter Olympics,49,Russian Federation,RUS,176,16,12,13,41
2006 Winter Olympics,49,Serbia & Montenegro,SCG,6,0,0,0,0
2006 Winter Olympics,49,Senegal,SEN,1,0,0,0,0
2006 Winter Olympics,49,Slovenia,SLO,37,0,0,0,0
2006 Winter Olympics,49,San Marino,SMR,1,0,0,0,0
2006 Winter Olympics,49,Switzerland,SUI,126,5,8,9,22
2006 Winter Olympics,49,Slovakia,SVK,58,0,1,0,1
2006 Winter Olympics,49,Sweden,SWE,108,36,21,8,65
2006 Winter Olympics,49,Thailand,THA,1,0,0,0,0
2006 Winter Olympics,49,Tajikistan,TJK,1,0,0,0,0
2006 Winter Olympics,49,Chinese Taipei,TPE,1,0,0,0,0
2006 Winter Olympics,49,Türkiye,TUR,6,0,0,0,0
2006 Winter Olympics,49,Ukraine,UKR,52,0,0,3,3
2006 Winter Olympics,49,United States,USA,205,9,11,34,54
2006 Winter Olympics,49,Uzbekistan,UZB,4,0,0,0,0
2006 Winter Olympics,49,Venezuela,VEN,1,0,0,0,0
2008 Summer Olympics,53,Afghanistan,AFG,4,0,0,1,1
2008 Summer Olympics,53,Netherlands Antilles,AHO,3,0,0,0,0
2008 Summer Olympics,53,Albania,ALB,11,0,0,0,0
2008 Summer Olympics,53,Algeria,ALG,60,0,1,1,2
2008 Summer Olympics,53,Andorra,AND,5,0,0,0,0
2008 Summer Olympics,53,Angola,ANG,32,0,0,0,0
2008 Summer Olympics,53,Antigua and Barbuda,ANT,5,0,0,0,0
2008 Summer Olympics,53,Argentina,ARG,139,21,0,33,54
2008 Summer Olympics,53,Armenia,ARM,26,0,1,4,5
2008 Summer Olympics,53,Aruba,ARU,2,0,0,0,0
2008 Summer Olympics,53,American Samoa,ASA,4,0,0,0,0
2008 Summer Olympics,53,Australia,AUS,439,31,42,77,150
2008 Summer Olympics,53,Austria,AUT,70,0,1,2,3
2008 Summer Olympics,53,Azerbaijan,AZE,46,1,1,4,6
2008 Summer Olympics,53,The Bahamas,BAH,25,0,6,1,7
2008 Summer Olympics,53,Bangladesh,BAN,5,0,0,0,0
2008 Summer Olympics,53,Barbados,BAR,8,0,0,0,0
2008 Summer Olympics,53,Burundi,BDI,3,0,0,0,0
2008 Summer Olympics,53,Belgium,BEL,100,7,0,0,7
2008 Summer Olympics,53,Benin,BEN,5,0,0,0,0
2008 Summer Olympics,53,Bermuda,BER,6,0,0,0,0
2008 Summer Olympics,53,Bhutan,BHU,2,0,0,0,0
2008 Summer Olympics,53,Bosnia and Herzegovina,BIH,5,0,0,0,0
2008 Summer Olympics,53,Belize,BIZ,4,0,0,0,0
2008 Summer Olympics,53,Belarus,BLR,180,7,4,14,25
2008 Summer Olympics,53,Bolivia,BOL,7,0,0,0,0
2008 Summer Olympics,53,Botswana,BOT,12,0,0,0,0
2008 Summer Olympics,53,Brazil,BRA,276,14,34,38,86
2008 Summer Olympics,53,Bahrain,BRN,15,0,0,0,0
2008 Summer Olympics,53,Bulgaria,BUL,70,1,1,3,5
2008 Summer Olympics,53,Burkina Faso,BUR,6,0,0,0,0
2008 Summer Olympics,53,Central African Republic,CAF,3,0,0,0,0
2008 Summer Olympics,53,Cambodia,CAM,4,0,0,0,0
2008 Summer Olympics,53,Canada,CAN,339,11,13,12,36
2008 Summer Olympics,53,Cayman Islands,CAY,4,0,0,0,0
2008 Summer Olympics,53,Congo,CGO,5,0,0,0,0
2008 Summer Olympics,53,Chad,CHA,2,0,0,0,0
2008 Summer Olympics,53,Chile,CHI,26,0,1,0,1
2008 Summer Olympics,53,People's Republic of China,CHN,617,71,56,59,186
2008 Summer Olympics,53,Côte d'Ivoire,CIV,23,0,0,0,0
2008 Summer Olympics,53,Cameroon,CMR,34,1,0,0,1
2008 Summer Olympics,53,Democratic Republic of the Congo,COD,5,0,0,0,0
2008 Summer Olympics,53,Cook Islands,COK,4,0,0,0,0
2008 Summer Olympics,53,Colombia,COL,67,0,2,1,3
2008 Summer Olympics,53,Comoros,COM,3,0,0,0,0
2008 Summer Olympics,53,Cabo Verde,CPV,2,0,0,0,0
2008 Summer Olympics,53,Costa Rica,CRC,8,0,0,0,0
2008 Summer Olympics,53,Croatia,CRO,101,0,2,3,5
2008 Summer Olympics,53,Cuba,CUB,163,3,33,17,53
2008 Summer Olympics,53,Cyprus,CYP,17,0,0,0,0
2008 Summer Olympics,53,Czechia,CZE,134,3,4,1,8
2008 Summer Olympics,53,Denmark,DEN,85,6,7,6,19
2008 Summer Olympics,53,Djibouti,DJI,2,0,0,0,0
2008 Summer Olympics,53,Dominica,DMA,2,0,0,0,0
2008 Summer Olympics,53,Dominican Republic,DOM,25,1,1,0,2
2008 Summer Olympics,53,Ecuador,ECU,25,0,1,0,1
2008 Summer Olympics,53,Egypt,EGY,104,0,0,2,2
2008 Summer Olympics,53,Eritrea,ERI,10,0,0,0,0
2008 Summer Olympics,53,El Salvador,ESA,11,0,0,0,0
2008 Summer Olympics,53,Spain,ESP,289,7,51,16,74
2008 Summer Olympics,53,Estonia,EST,47,1,2,0,3
2008 Summer Olympics,53,Ethiopia,ETH,28,4,2,1,7
2008 Summer Olympics,53,Fiji,FIJ,6,0,0,0,0
2008 Summer Olympics,53,Finland,FIN,58,1,2,2,5
2008 Summer Olympics,53,France,FRA,316,25,24,30,79
2008 Summer Olympics,53,Federated States of Micronesia,FSM,5,0,0,0,0
2008 Summer Olympics,53,Gabon,GAB,4,0,0,0,0
2008 Summer Olympics,53,The Gambia,GAM,3,0,0,0,0
2008 Summer Olympics,53,Great Britain,GBR,319,31,25,35,91
2008 Summer Olympics,53,Guinea Bissau,GBS,3,0,0,0,0
2008 Summer Olympics,53,Georgia,GEO,35,3,2,2,7
2008 Summer Olympics,53,Equatorial Guinea,GEQ,3,0,0,0,0
2008 Summer Olympics,53,Germany,GER,433,43,17,42,102
2008 Summer Olympics,53,Ghana,GHA,9,0,0,0,0
2008 Summer Olympics,53,Greece,GRE,153,0,3,3,6
2008 Summer Olympics,53,Grenada,GRN,9,0,0,0,0
2008 Summer Olympics,53,Guatemala,GUA,12,0,0,0,0
2008 Summer Olympics,53,Guinea,GUI,5,0,0,0,0
2008 Summer Olympics,53,Guam,GUM,6,0,0,0,0
2008 Summer Olympics,53,Guyana,GUY,4,0,0,0,0
2008 Summer Olympics,53,Haiti,HAI,7,0,0,0,0
2008 Summer Olympics,53,"Hong Kong, China",HKG,40,0,0,0,0
2008 Summer Olympics,53,Honduras,HON,26,0,0,0,0
2008 Summer Olympics,53,Hungary,HUN,171,16,8,3,27
2008 Summer Olympics,53,Indonesia,INA,29,2,2,4,8
2008 Summer Olympics,53,India,IND,55,1,0,2,3
2008 Summer Olympics,53,Islamic Republic of Iran,IRI,60,1,0,1,2
2008 Summer Olympics,53,Ireland,IRL,55,0,1,2,3
2008 Summer Olympics,53,Iraq,IRQ,4,0,0,0,0
2008 Summer Olympics,53,Iceland,ISL,27,0,14,0,14
2008 Summer Olympics,53,Israel,ISR,44,0,0,1,1
2008 Summer Olympics,53,United States Virgin Islands,ISV,7,0,0,0,0
2008 Summer Olympics,53,Italy,ITA,343,8,14,21,43
2008 Summer Olympics,53,British Virgin Islands,IVB,2,0,0,0,0
2008 Summer Olympics,53,Jamaica,JAM,54,5,9,2,16
2008 Summer Olympics,53,Jordan,JOR,7,0,0,0,0
2008 Summer Olympics,53,Japan,JPN,346,23,17,12,52
2008 Summer Olympics,53,Kazakhstan,KAZ,131,2,3,4,9
2008 Summer Olympics,53,Kenya,KEN,46,6,4,6,16
2008 Summer Olympics,53,Kyrgyzstan,KGZ,20,0,1,2,3
2008 Summer Olympics,53,Kiribati,KIR,2,0,0,0,0
2008 Summer Olympics,53,Republic of Korea,KOR,276,41,12,26,79
2008 Summer Olympics,53,Kingdom of Saudi Arabia,KSA,14,0,0,0,0
2008 Summer Olympics,53,Kuwait,KUW,8,0,0,0,0
2008 Summer Olympics,53,Lao People's Democratic Republic,LAO,4,0,0,0,0
2008 Summer Olympics,53,Latvia,LAT,48,1,1,1,3
2008 Summer Olympics,53,Libya,LBA,7,0,0,0,0
2008 Summer Olympics,53,Lebanon,LBN,7,0,0,0,0
2008 Summer Olympics,53,Liberia,LBR,3,0,0,0,0
2008 Summer Olympics,53,Saint Lucia,LCA,4,0,0,0,0
2008 Summer Olympics,53,Lesotho,LES,5,0,0,0,0
2008 Summer Olympics,53,Liechtenstein,LIE,2,0,0,0,0
2008 Summer Olympics,53,Lithuania,LTU,71,0,3,2,5
2008 Summer Olympics,53,Luxembourg,LUX,13,0,0,0,0
2008 Summer Olympics,53,Madagascar,MAD,6,0,0,0,0
2008 Summer Olympics,53,Morocco,MAR,47,0,1,1,2
2008 Summer Olympics,53,Malaysia,MAS,39,0,1,0,1
2008 Summer Olympics,53,Malawi,MAW,4,0,0,0,0
2008 Summer Olympics,53,Republic of Moldova,MDA,29,0,0,1,1
2008 Summer Olympics,53,Maldives,MDV,4,0,0,0,0
2008 Summer Olympics,53,Mexico,MEX,86,2,0,3,5
2008 Summer Olympics,53,Mongolia,MGL,28,2,2,0,4
2008 Summer Olympics,53,Marshall Islands,MHL,5,0,0,0,0
2008 Summer Olympics,53,North Macedonia,MKD,7,0,0,0,0
2008 Summer Olympics,53,Mali,MLI,17,0,0,0,0
2008 Summer Olympics,53,Malta,MLT,6,0,0,0,0
2008 Summer Olympics,53,Montenegro,MNE,19,0,0,0,0
2008 Summer Olympics,53,Monaco,MON,5,0,0,0,0
2008 Summer Olympics,53,Mozambique,MOZ,4,0,0,0,0
2008 Summer Olympics,53,Mauritius,MRI,12,0,0,1,1
2008 Summer Olympics,53,Mauritania,MTN,2,0,0,0,0
2008 Summer Olympics,53,Myanmar,MYA,8,0,0,0,0
2008 Summer Olympics,53,Namibia,NAM,10,0,0,0,0
2008 Summer Olympics,53,Nicaragua,NCA,6,0,0,0,0
2008 Summer Olympics,53,Netherlands,NED,246,42,18,4,64
2008 Summer Olympics,53,Nepal,NEP,8,0,0,0,0
2008 Summer Olympics,53,Nigeria,NGR,82,0,24,2,26
2008 Summer Olympics,53,Niger,NIG,5,0,0,0,0
2008 Summer Olympics,53,Norway,NOR,85,16,5,1,22
2008 Summer Olympics,53,Nauru,NRU,1,0,0,0,0
2008 Summer Olympics,53,New Zealand,NZL,186,4,2,9,15
2008 Summer Olympics,53,Oman,OMA,4,0,0,0,0
2008 Summer Olympics,53,Pakistan,PAK,23,0,0,0,0
2008 Summer Olympics,53,Panama,PAN,5,1,0,0,1
2008 Summer Olympics,53,Paraguay,PAR,7,0,0,0,0
2008 Summer Olympics,53,Peru,PER,13,0,0,0,0
2008 Summer Olympics,53,Philippines,PHI,19,0,0,0,0
2008 Summer Olympics,53,Palestine,PLE,4,0,0,0,0
2008 Summer Olympics,53,Palau,PLW,5,0,0,0,0
2008 Summer Olympics,53,Papua New Guinea,PNG,7,0,0,0,0
2008 Summer Olympics,53,Poland,POL,264,7,12,2,21
2008 Summer Olympics,53,Portugal,POR,77,1,1,0,2
2008 Summer Olympics,53,Democratic People's Republic of Korea,PRK,63,2,2,2,6
2008 Summer Olympics,53,Puerto Rico,PUR,22,0,0,0,0
2008 Summer Olympics,53,Qatar,QAT,20,0,0,0,0
2008 Summer Olympics,53,Romania,ROU,104,5,1,17,23
2008 Summer Olympics,53,South Africa,RSA,142,0,1,0,1
2008 Summer Olympics,53,Russian Federation,RUS,465,41,33,48,122
2008 Summer Olympics,53,Rwanda,RWA,4,0,0,0,0
2008 Summer Olympics,53,Samoa,SAM,6,0,1,0,1
2008 Summer Olympics,53,Senegal,SEN,15,0,0,0,0
2008 Summer Olympics,53,Seychelles,SEY,9,0,0,0,0
2008 Summer Olympics,53,Singapore,SGP,29,0,3,0,3
2008 Summer Olympics,53,Saint Kitts and Nevis,SKN,4,0,0,0,0
2008 Summer Olympics,53,Sierra Leone,SLE,3,0,0,0,0
2008 Summer Olympics,53,Slovenia,SLO,62,1,2,2,5
2008 Summer Olympics,53,San Marino,SMR,4,0,0,0,0
2008 Summer Olympics,53,Solomon Islands,SOL,3,0,0,0,0
2008 Summer Olympics,53,Somalia,SOM,2,0,0,0,0
2008 Summer Olympics,53,Serbia,SRB,92,0,1,14,15
2008 Summer Olympics,53,Sri Lanka,SRI,9,0,0,0,0
2008 Summer Olympics,53,São Tomé and Príncipe,STP,3,0,0,0,0
2008 Summer Olympics,53,Sudan,SUD,9,0,1,0,1
2008 Summer Olympics,53,Switzerland,SUI,84,3,1,7,11
2008 Summer Olympics,53,Suriname,SUR,4,0,0,0,0
2008 Summer Olympics,53,Slovakia,SVK,57,4,6,0,10
2008 Summer Olympics,53,Sweden,SWE,126,0,5,2,7
2008 Summer Olympics,53,Eswatini,SWZ,4,0,0,0,0
2008 Summer Olympics,53,Syrian Arab Republic,SYR,8,0,0,0,0
2008 Summer Olympics,53,United Republic of Tanzania,TAN,10,0,0,0,0
2008 Summer Olympics,53,Tonga,TGA,3,0,0,0,0
2008 Summer Olympics,53,Thailand,THA,52,2,2,2,6
2008 Summer Olympics,53,Tajikistan,TJK,15,0,1,1,2
2008 Summer Olympics,53,Turkmenistan,TKM,10,0,0,0,0
2008 Summer Olympics,53,Timor-Leste,TLS,2,0,0,0,0
2008 Summer Olympics,53,Togo,TOG,4,0,0,1,1
2008 Summer Olympics,53,Chinese Taipei,TPE,86,1,1,2,4
2008 Summer Olympics,53,Trinidad and Tobago,TTO,30,5,1,0,6
2008 Summer Olympics,53,Tunisia,TUN,29,1,0,0,1
2008 Summer Olympics,53,Türkiye,TUR,68,1,1,3,5
2008 Summer Olympics,53,Tuvalu,TUV,3,0,0,0,0
2008 Summer Olympics,53,United Arab Emirates,UAE,8,0,0,0,0
2008 Summer Olympics,53,Uganda,UGA,11,0,0,0,0
2008 Summer Olympics,53,Ukraine,UKR,250,10,4,12,26
2008 Summer Olympics,53,Uruguay,URU,12,0,0,0,0
2008 Summer Olympics,53,United States,USA,604,131,110,82,323
2008 Summer Olympics,53,Uzbekistan,UZB,56,0,1,3,4
2008 Summer Olympics,53,Vanuatu,VAN,3,0,0,0,0
2008 Summer Olympics,53,Venezuela,VEN,110,0,0,1,1
2008 Summer Olympics,53,Vietnam,VIE,21,0,1,0,1
2008 Summer Olympics,53,Saint Vincent and the Grenadines,VIN,2,0,0,0,0
2008 Summer Olympics,53,Yemen,YEM,5,0,0,0,0
2008 Summer Olympics,53,Zambia,ZAM,8,0,0,0,0
2008 Summer Olympics,53,Zimbabwe,ZIM,13,1,3,0,4
2010 Winter Olympics,57,Albania,ALB,1,0,0,0,0
2010 Winter Olympics,57,Algeria,ALG,1,0,0,0,0
2010 Winter Olympics,57,Andorra,AND,6,0,0,0,0
2010 Winter Olympics,57,Argentina,ARG,7,0,0,0,0
2010 Winter Olympics,57,Armenia,ARM,4,0,0,0,0
2010 Winter Olympics,57,Australia,AUS,40,2,1,0,3
2010 Winter Olympics,57,Austria,AUT,76,11,9,6,26
2010 Winter Olympics,57,Azerbaijan,AZE,2,0,0,0,0
2010 Winter Olympics,57,Belgium,BEL,8,0,0,0,0
2010 Winter Olympics,57,Bermuda,BER,1,0,0,0,0
2010 Winter Olympics,57,Bosnia and Herzegovina,BIH,5,0,0,0,0
2010 Winter Olympics,57,Belarus,BLR,48,1,1,1,3
2010 Winter Olympics,57,Brazil,BRA,5,0,0,0,0
2010 Winter Olympics,57,Bulgaria,BUL,19,0,0,0,0
2010 Winter Olympics,57,Canada,CAN,202,69,16,8,93
2010 Winter Olympics,57,Cayman Islands,CAY,1,0,0,0,0
2010 Winter Olympics,57,Chile,CHI,3,0,0,0,0
2010 Winter Olympics,57,People's Republic of China,CHN,89,10,3,8,21
2010 Winter Olympics,57,Colombia,COL,1,0,0,0,0
2010 Winter Olympics,57,Croatia,CRO,19,0,2,1,3
2010 Winter Olympics,57,Cyprus,CYP,2,0,0,0,0
2010 Winter Olympics,57,Czechia,CZE,92,2,0,7,9
2010 Winter Olympics,57,Denmark,DEN,18,0,0,0,0
2010 Winter Olympics,57,Spain,ESP,18,0,0,0,0
2010 Winter Olympics,57,Estonia,EST,30,0,1,0,1
2010 Winter Olympics,57,Ethiopia,ETH,1,0,0,0,0
2010 Winter Olympics,57,Finland,FIN,94,0,1,49,50
2010 Winter Olympics,57,France,FRA,104,2,6,6,14
2010 Winter Olympics,57,Great Britain,GBR,52,1,0,0,1
2010 Winter Olympics,57,Georgia,GEO,7,0,0,0,0
2010 Winter Olympics,57,Germany,GER,151,15,24,15,54
2010 Winter Olympics,57,Ghana,GHA,1,0,0,0,0
2010 Winter Olympics,57,Greece,GRE,7,0,0,0,0
2010 Winter Olympics,57,"Hong Kong, China",HKG,1,0,0,0,0
2010 Winter Olympics,57,Hungary,HUN,16,0,0,0,0
2010 Winter Olympics,57,India,IND,3,0,0,0,0
2010 Winter Olympics,57,Islamic Republic of Iran,IRI,4,0,0,0,0
2010 Winter Olympics,57,Ireland,IRL,6,0,0,0,0
2010 Winter Olympics,57,Iceland,ISL,4,0,0,0,0
2010 Winter Olympics,57,Israel,ISR,3,0,0,0,0
2010 Winter Olympics,57,Italy,ITA,110,1,1,3,5
2010 Winter Olympics,57,Jamaica,JAM,1,0,0,0,0
2010 Winter Olympics,57,Japan,JPN,93,0,6,2,8
2010 Winter Olympics,57,Kazakhstan,KAZ,37,0,1,0,1
2010 Winter Olympics,57,Kyrgyzstan,KGZ,2,0,0,0,0
2010 Winter Olympics,57,Republic of Korea,KOR,46,6,10,2,18
2010 Winter Olympics,57,Latvia,LAT,55,0,3,0,3
2010 Winter Olympics,57,Lebanon,LBN,3,0,0,0,0
2010 Winter Olympics,57,Liechtenstein,LIE,4,0,0,0,0
2010 Winter Olympics,57,Lithuania,LTU,6,0,0,0,0
2010 Winter Olympics,57,Morocco,MAR,1,0,0,0,0
2010 Winter Olympics,57,Republic of Moldova,MDA,7,0,0,0,0
2010 Winter Olympics,57,Mexico,MEX,1,0,0,0,0
2010 Winter Olympics,57,Mongolia,MGL,2,0,0,0,0
2010 Winter Olympics,57,North Macedonia,MKD,3,0,0,0,0
2010 Winter Olympics,57,Montenegro,MNE,1,0,0,0,0
2010 Winter Olympics,57,Monaco,MON,3,0,0,0,0
2010 Winter Olympics,57,Netherlands,NED,32,4,1,6,11
2010 Winter Olympics,57,Nepal,NEP,1,0,0,0,0
2010 Winter Olympics,57,Norway,NOR,98,16,15,9,40
2010 Winter Olympics,57,New Zealand,NZL,16,0,0,0,0
2010 Winter Olympics,57,Pakistan,PAK,1,0,0,0,0
2010 Winter Olympics,57,Peru,PER,3,0,0,0,0
2010 Winter Olympics,57,Poland,POL,46,1,3,5,9
2010 Winter Olympics,57,Portugal,POR,1,0,0,0,0
2010 Winter Olympics,57,Democratic People's Republic of Korea,PRK,2,0,0,0,0
2010 Winter Olympics,57,Romania,ROU,28,0,0,0,0
2010 Winter Olympics,57,South Africa,RSA,2,0,0,0,0
2010 Winter Olympics,57,Russian Federation,RUS,177,6,5,14,25
2010 Winter Olympics,57,Senegal,SEN,1,0,0,0,0
2010 Winter Olympics,57,Slovenia,SLO,47,0,2,1,3
2010 Winter Olympics,57,San Marino,SMR,1,0,0,0,0
2010 Winter Olympics,57,Serbia,SRB,10,0,0,0,0
2010 Winter Olympics,57,Switzerland,SUI,138,6,0,7,13
2010 Winter Olympics,57,Slovakia,SVK,72,1,1,1,3
2010 Winter Olympics,57,Sweden,SWE,105,12,3,4,19
2010 Winter Olympics,57,Tajikistan,TJK,1,0,0,0,0
2010 Winter Olympics,57,Chinese Taipei,TPE,1,0,0,0,0
2010 Winter Olympics,57,Türkiye,TUR,5,0,0,0,0
2010 Winter Olympics,57,Ukraine,UKR,45,0,0,0,0
2010 Winter Olympics,57,United States,USA,214,12,64,22,98
2010 Winter Olympics,57,Uzbekistan,UZB,3,0,0,0,0
2012 Summer Olympics,54,Afghanistan,AFG,6,0,0,1,1
2012 Summer Olympics,54,Albania,ALB,9,0,0,0,0
2012 Summer Olympics,54,Algeria,ALG,39,1,0,0,1
2012 Summer Olympics,54,Andorra,AND,6,0,0,0,0
2012 Summer Olympics,54,Angola,ANG,35,0,0,0,0
2012 Summer Olympics,54,Antigua and Barbuda,ANT,4,0,0,0,0
2012 Summer Olympics,54,Argentina,ARG,142,1,18,3,22
2012 Summer Olympics,54,Armenia,ARM,24,0,1,1,2
2012 Summer Olympics,54,Aruba,ARU,4,0,0,0,0
2012 Summer Olympics,54,American Samoa,ASA,5,0,0,0,0
2012 Summer Olympics,54,Australia,AUS,410,19,36,61,116
2012 Summer Olympics,54,Austria,AUT,70,0,0,0,0
2012 Summer Olympics,54,Azerbaijan,AZE,52,2,2,5,9
2012 Summer Olympics,54,The Bahamas,BAH,21,4,0,0,4
2012 Summer Olympics,54,Bangladesh,BAN,5,0,0,0,0
2012 Summer Olympics,54,Barbados,BAR,6,0,0,0,0
2012 Summer Olympics,54,Burundi,BDI,6,0,0,0,0
2012 Summer Olympics,54,Belgium,BEL,115,0,1,2,3
2012 Summer Olympics,54,Benin,BEN,5,0,0,0,0
2012 Summer Olympics,54,Bermuda,BER,8,0,0,0,0
2012 Summer Olympics,54,Bhutan,BHU,2,0,0,0,0
2012 Summer Olympics,54,Bosnia and Herzegovina,BIH,6,0,0,0,0
2012 Summer Olympics,54,Belize,BIZ,3,0,0,0,0
2012 Summer Olympics,54,Belarus,BLR,166,3,12,6,21
2012 Summer Olympics,54,Bolivia,BOL,5,0,0,0,0
2012 Summer Olympics,54,Botswana,BOT,4,0,1,0,1
2012 Summer Olympics,54,Brazil,BRA,260,14,38,11,63
2012 Summer Olympics,54,Bahrain,BRN,12,1,0,0,1
2012 Summer Olympics,54,Brunei Darussalam,BRU,3,0,0,0,0
2012 Summer Olympics,54,Bulgaria,BUL,63,0,2,1,3
2012 Summer Olympics,54,Burkina Faso,BUR,5,0,0,0,0
2012 Summer Olympics,54,Central African Republic,CAF,6,0,0,0,0
2012 Summer Olympics,54,Cambodia,CAM,6,0,0,0,0
2012 Summer Olympics,54,Canada,CAN,277,2,22,35,59
2012 Summer Olympics,54,Cayman Islands,CAY,5,0,0,0,0
2012 Summer Olympics,54,Congo,CGO,7,0,0,0,0
2012 Summer Olympics,54,Chad,CHA,2,0,0,0,0
2012 Summer Olympics,54,Chile,CHI,35,0,0,0,0
2012 Summer Olympics,54,People's Republic of China,CHN,378,57,44,28,129
2012 Summer Olympics,54,Côte d'Ivoire,CIV,9,0,0,0,0
2012 Summer Olympics,54,Cameroon,CMR,37,0,0,1,1
2012 Summer Olympics,54,Democratic Republic of the Congo,COD,4,0,0,0,0
2012 Summer Olympics,54,Cook Islands,COK,8,0,0,0,0
2012 Summer Olympics,54,Colombia,COL,106,1,3,5,9
2012 Summer Olympics,54,Comoros,COM,3,0,0,0,0
2012 Summer Olympics,54,Cabo Verde,CPV,3,0,0,0,0
2012 Summer Olympics,54,Costa Rica,CRC,11,0,0,0,0
2012 Summer Olympics,54,Croatia,CRO,110,15,4,16,35
2012 Summer Olympics,54,Cuba,CUB,109,5,3,7,15
2012 Summer Olympics,54,Cyprus,CYP,13,0,1,0,1
2012 Summer Olympics,54,Czechia,CZE,133,4,5,6,15
2012 Summer Olympics,54,Denmark,DEN,115,3,5,8,16
2012 Summer Olympics,54,Djibouti,DJI,5,0,0,0,0
2012 Summer Olympics,54,Dominica,DMA,2,0,0,0,0
2012 Summer Olympics,54,Dominican Republic,DOM,33,1,1,0,2
2012 Summer Olympics,54,Ecuador,ECU,36,0,0,0,0
2012 Summer Olympics,54,Egypt,EGY,119,0,3,1,4
2012 Summer Olympics,54,Eritrea,ERI,12,0,0,0,0
2012 Summer Olympics,54,El Salvador,ESA,10,0,0,0,0
2012 Summer Olympics,54,Spain,ESP,286,6,34,28,68
2012 Summer Olympics,54,Estonia,EST,32,0,1,1,2
2012 Summer Olympics,54,Ethiopia,ETH,34,3,2,3,8
2012 Summer Olympics,54,Fiji,FIJ,9,0,0,0,0
2012 Summer Olympics,54,Finland,FIN,56,0,2,3,5
2012 Summer Olympics,54,France,FRA,330,30,30,22,82
2012 Summer Olympics,54,Federated States of Micronesia,FSM,6,0,0,0,0
2012 Summer Olympics,54,Gabon,GAB,28,0,1,0,1
2012 Summer Olympics,54,The Gambia,GAM,2,0,0,0,0
2012 Summer Olympics,54,Great Britain,GBR,547,48,31,49,128
2012 Summer Olympics,54,Guinea Bissau,GBS,4,0,0,0,0
2012 Summer Olympics,54,Georgia,GEO,35,1,2,3,6
2012 Summer Olympics,54,Equatorial Guinea,GEQ,2,0,0,0,0
2012 Summer Olympics,54,Germany,GER,388,47,28,21,96
2012 Summer Olympics,54,Ghana,GHA,9,0,0,0,0
2012 Summer Olympics,54,Greece,GRE,102,0,0,3,3
2012 Summer Olympics,54,Grenada,GRN,9,1,0,0,1
2012 Summer Olympics,54,Guatemala,GUA,19,0,1,0,1
2012 Summer Olympics,54,Guinea,GUI,4,0,0,0,0
2012 Summer Olympics,54,Guam,GUM,8,0,0,0,0
2012 Summer Olympics,54,Guyana,GUY,6,0,0,0,0
2012 Summer Olympics,54,Haiti,HAI,5,0,0,0,0
2012 Summer Olympics,54,"Hong Kong, China",HKG,41,0,0,1,1
2012 Summer Olympics,54,Honduras,HON,31,0,0,0,0
2012 Summer Olympics,54,Hungary,HUN,152,12,8,6,26
2012 Summer Olympics,54,Indonesia,INA,22,0,2,1,3
2012 Summer Olympics,54,India,IND,83,0,2,4,6
2012 Summer Olympics,54,IOA,IOA,4,0,0,0,0
2012 Summer Olympics,54,Islamic Republic of Iran,IRI,53,7,5,1,13
2012 Summer Olympics,54,Ireland,IRL,64,1,1,4,6
2012 Summer Olympics,54,Iraq,IRQ,8,0,0,0,0
2012 Summer Olympics,54,Iceland,ISL,28,0,0,0,0
2012 Summer Olympics,54,Israel,ISR,37,0,0,0,0
2012 Summer Olympics,54,United States Virgin Islands,ISV,7,0,0,0,0
2012 Summer Olympics,54,Italy,ITA,281,16,22,30,68
2012 Summer Olympics,54,British Virgin Islands,IVB,2,0,0,0,0
2012 Summer Olympics,54,Jamaica,JAM,48,8,15,4,27
2012 Summer Olympics,54,Jordan,JOR,9,0,0,0,0
2012 Summer Olympics,54,Japan,JPN,303,7,48,33,88
2012 Summer Olympics,54,Kazakhstan,KAZ,115,3,1,7,11
2012 Summer Olympics,54,Kenya,KEN,47,2,4,7,13
2012 Summer Olympics,54,Kyrgyzstan,KGZ,14,0,0,0,0
2012 Summer Olympics,54,Kiribati,KIR,3,0,0,0,0
2012 Summer Olympics,54,Republic of Korea,KOR,259,18,14,35,67
2012 Summer Olympics,54,Kingdom of Saudi Arabia,KSA,18,0,0,4,4
2012 Summer Olympics,54,Kuwait,KUW,10,0,0,1,1
2012 Summer Olympics,54,Lao People's Democratic Republic,LAO,3,0,0,0,0
2012 Summer Olympics,54,Latvia,LAT,45,1,0,2,3
2012 Summer Olympics,54,Libya,LBA,4,0,0,0,0
2012 Summer Olympics,54,Lebanon,LBN,10,0,0,0,0
2012 Summer Olympics,54,Liberia,LBR,4,0,0,0,0
2012 Summer Olympics,54,Saint Lucia,LCA,4,0,0,0,0
2012 Summer Olympics,54,Lesotho,LES,4,0,0,0,0
2012 Summer Olympics,54,Liechtenstein,LIE,3,0,0,0,0
2012 Summer Olympics,54,Lithuania,LTU,62,2,0,3,5
2012 Summer Olympics,54,Luxembourg,LUX,9,0,0,0,0
2012 Summer Olympics,54,Madagascar,MAD,7,0,0,0,0
2012 Summer Olympics,54,Morocco,MAR,70,0,0,1,1
2012 Summer Olympics,54,Malaysia,MAS,29,0,1,1,2
2012 Summer Olympics,54,Malawi,MAW,3,0,0,0,0
2012 Summer Olympics,54,Republic of Moldova,MDA,20,0,0,0,0
2012 Summer Olympics,54,Maldives,MDV,5,0,0,0,0
2012 Summer Olympics,54,Mexico,MEX,105,22,5,4,31
2012 Summer Olympics,54,Mongolia,MGL,29,0,2,3,5
2012 Summer Olympics,54,Marshall Islands,MHL,4,0,0,0,0
2012 Summer Olympics,54,North Macedonia,MKD,4,0,0,0,0
2012 Summer Olympics,54,Mali,MLI,6,0,0,0,0
2012 Summer Olympics,54,Malta,MLT,5,0,0,0,0
2012 Summer Olympics,54,Montenegro,MNE,34,0,15,0,15
2012 Summer Olympics,54,Monaco,MON,6,0,0,0,0
2012 Summer Olympics,54,Mozambique,MOZ,6,0,0,0,0
2012 Summer Olympics,54,Mauritius,MRI,11,0,0,0,0
2012 Summer Olympics,54,Mauritania,MTN,2,0,0,0,0
2012 Summer Olympics,54,Myanmar,MYA,6,0,0,0,0
2012 Summer Olympics,54,Namibia,NAM,9,0,0,0,0
2012 Summer Olympics,54,Nicaragua,NCA,6,0,0,0,0
2012 Summer Olympics,54,Netherlands,NED,177,23,30,19,72
2012 Summer Olympics,54,Nepal,NEP,5,0,0,0,0
2012 Summer Olympics,54,Nigeria,NGR,49,0,0,0,0
2012 Summer Olympics,54,Niger,NIG,6,0,0,0,0
2012 Summer Olympics,54,Norway,NOR,64,16,1,1,18
2012 Summer Olympics,54,Nauru,NRU,2,0,0,0,0
2012 Summer Olympics,54,New Zealand,NZL,195,9,3,15,27
2012 Summer Olympics,54,Oman,OMA,4,0,0,0,0
2012 Summer Olympics,54,Pakistan,PAK,23,0,0,0,0
2012 Summer Olympics,54,Panama,PAN,8,0,0,0,0
2012 Summer Olympics,54,Paraguay,PAR,8,0,0,0,0
2012 Summer Olympics,54,Peru,PER,16,0,0,0,0
2012 Summer Olympics,54,Philippines,PHI,11,0,0,0,0
2012 Summer Olympics,54,Palestine,PLE,5,0,0,0,0
2012 Summer Olympics,54,Palau,PLW,5,0,0,0,0
2012 Summer Olympics,54,Papua New Guinea,PNG,8,0,0,0,0
2012 Summer Olympics,54,Poland,POL,210,3,2,8,13
2012 Summer Olympics,54,Portugal,POR,77,0,2,0,2
2012 Summer Olympics,54,Democratic People's Republic of Korea,PRK,56,4,0,3,7
2012 Summer Olympics,54,Puerto Rico,PUR,25,0,1,1,2
2012 Summer Olympics,54,Qatar,QAT,12,0,1,1,2
2012 Summer Olympics,54,Romania,ROU,105,2,7,5,14
2012 Summer Olympics,54,South Africa,RSA,133,7,1,1,9
2012 Summer Olympics,54,Russian Federation,RUS,430,44,29,45,118
2012 Summer Olympics,54,Rwanda,RWA,7,0,0,0,0
2012 Summer Olympics,54,Samoa,SAM,8,0,0,0,0
2012 Summer Olympics,54,Senegal,SEN,36,0,0,0,0
2012 Summer Olympics,54,Seychelles,SEY,6,0,0,0,0
2012 Summer Olympics,54,Singapore,SGP,23,0,0,4,4
2012 Summer Olympics,54,Saint Kitts and Nevis,SKN,5,0,0,0,0
2012 Summer Olympics,54,Sierra Leone,SLE,2,0,0,0,0
2012 Summer Olympics,54,Slovenia,SLO,65,1,1,3,5
2012 Summer Olympics,54,San Marino,SMR,4,0,0,0,0
2012 Summer Olympics,54,Solomon Islands,SOL,4,0,0,0,0
2012 Summer Olympics,54,Somalia,SOM,2,0,0,0,0
2012 Summer Olympics,54,Serbia,SRB,116,1,1,14,16
2012 Summer Olympics,54,Sri Lanka,SRI,7,0,0,0,0
2012 Summer Olympics,54,São Tomé and Príncipe,STP,2,0,0,0,0
2012 Summer Olympics,54,Sudan,SUD,6,0,0,0,0
2012 Summer Olympics,54,Switzerland,SUI,104,2,2,0,4
2012 Summer Olympics,54,Suriname,SUR,5,0,0,0,0
2012 Summer Olympics,54,Slovakia,SVK,47,0,1,4,5
2012 Summer Olympics,54,Sweden,SWE,140,2,18,3,23
2012 Summer Olympics,54,Eswatini,SWZ,3,0,0,0,0
2012 Summer Olympics,54,Syrian Arab Republic,SYR,10,0,0,0,0
2012 Summer Olympics,54,United Republic of Tanzania,TAN,6,0,0,0,0
2012 Summer Olympics,54,Tonga,TGA,3,0,0,0,0
2012 Summer Olympics,54,Thailand,THA,37,0,2,2,4
2012 Summer Olympics,54,Tajikistan,TJK,16,0,0,1,1
2012 Summer Olympics,54,Turkmenistan,TKM,10,0,0,0,0
2012 Summer Olympics,54,Timor-Leste,TLS,2,0,0,0,0
2012 Summer Olympics,54,Togo,TOG,6,0,0,0,0
2012 Summer Olympics,54,Chinese Taipei,TPE,44,1,0,1,2
2012 Summer Olympics,54,Trinidad and Tobago,TTO,26,1,4,5,10
2012 Summer Olympics,54,Tunisia,TUN,84,2,0,1,3
2012 Summer Olympics,54,Türkiye,TUR,112,1,1,1,3
2012 Summer Olympics,54,Tuvalu,TUV,3,0,0,0,0
2012 Summer Olympics,54,United Arab Emirates,UAE,30,0,0,0,0
2012 Summer Olympics,54,Uganda,UGA,15,1,0,0,1
2012 Summer Olympics,54,Ukraine,UKR,231,8,4,16,28
2012 Summer Olympics,54,Uruguay,URU,33,0,0,0,0
2012 Summer Olympics,54,United States,USA,538,153,55,47,255
2012 Summer Olympics,54,Uzbekistan,UZB,53,0,0,3,3
2012 Summer Olympics,54,Vanuatu,VAN,5,0,0,0,0
2012 Summer Olympics,54,Venezuela,VEN,69,1,0,0,1
2012 Summer Olympics,54,Vietnam,VIE,18,0,0,1,1
2012 Summer Olympics,54,Saint Vincent and the Grenadines,VIN,3,0,0,0,0
2012 Summer Olympics,54,Yemen,YEM,4,0,0,0,0
2012 Summer Olympics,54,Zambia,ZAM,7,0,0,0,0
2012 Summer Olympics,54,Zimbabwe,ZIM,7,0,0,0,0
2014 Winter Olympics,58,Albania,ALB,2,0,0,0,0
2014 Winter Olympics,58,Andorra,AND,6,0,0,0,0
2014 Winter Olympics,58,Argentina,ARG,7,0,0,0,0
2014 Winter Olympics,58,Armenia,ARM,4,0,0,0,0
2014 Winter Olympics,58,Australia,AUS,60,0,2,1,3
2014 Winter Olympics,58,Austria,AUT,127,4,12,11,27
2014 Winter Olympics,58,Azerbaijan,AZE,4,0,0,0,0
2014 Winter Olympics,58,Belgium,BEL,7,0,0,0,0
2014 Winter Olympics,58,Bermuda,BER,1,0,0,0,0
2014 Winter Olympics,58,Bosnia and Herzegovina,BIH,5,0,0,0,0
2014 Winter Olympics,58,Belarus,BLR,26,5,0,1,6
2014 Winter Olympics,58,Brazil,BRA,13,0,0,0,0
2014 Winter Olympics,58,Bulgaria,BUL,18,0,0,0,0
2014 Winter Olympics,58,Canada,CAN,222,63,23,5,91
2014 Winter Olympics,58,Cayman Islands,CAY,1,0,0,0,0
2014 Winter Olympics,58,Chile,CHI,6,0,0,0,0
2014 Winter Olympics,58,People's Republic of China,CHN,65,3,4,6,13
2014 Winter Olympics,58,Croatia,CRO,11,0,1,0,1
2014 Winter Olympics,58,Cyprus,CYP,2,0,0,0,0
2014 Winter Olympics,58,Czechia,CZE,87,2,7,6,15
2014 Winter Olympics,58,Denmark,DEN,12,0,0,0,0
2014 Winter Olympics,58,Dominica,DMA,2,0,0,0,0
2014 Winter Olympics,58,Spain,ESP,20,0,0,0,0
2014 Winter Olympics,58,Estonia,EST,25,0,0,0,0
2014 Winter Olympics,58,Finland,FIN,102,2,7,25,34
2014 Winter Olympics,58,France,FRA,107,4,4,10,18
2014 Winter Olympics,58,Great Britain,GBR,55,1,5,10,16
2014 Winter Olympics,58,Georgia,GEO,4,0,0,0,0
2014 Winter Olympics,58,Germany,GER,152,15,12,9,36
2014 Winter Olympics,58,Greece,GRE,7,0,0,0,0
2014 Winter Olympics,58,"Hong Kong, China",HKG,1,0,0,0,0
2014 Winter Olympics,58,Hungary,HUN,16,0,0,0,0
2014 Winter Olympics,58,India,IND,2,0,0,0,0
2014 Winter Olympics,58,IOA,IOA,1,0,0,0,0
2014 Winter Olympics,58,Islamic Republic of Iran,IRI,5,0,0,0,0
2014 Winter Olympics,58,Ireland,IRL,5,0,0,0,0
2014 Winter Olympics,58,Iceland,ISL,5,0,0,0,0
2014 Winter Olympics,58,Israel,ISR,5,0,0,0,0
2014 Winter Olympics,58,United States Virgin Islands,ISV,1,0,0,0,0
2014 Winter Olympics,58,Italy,ITA,112,0,2,13,15
2014 Winter Olympics,58,British Virgin Islands,IVB,1,0,0,0,0
2014 Winter Olympics,58,Jamaica,JAM,2,0,0,0,0
2014 Winter Olympics,58,Japan,JPN,113,1,4,6,11
2014 Winter Olympics,58,Kazakhstan,KAZ,51,0,0,1,1
2014 Winter Olympics,58,Kyrgyzstan,KGZ,1,0,0,0,0
2014 Winter Olympics,58,Republic of Korea,KOR,71,7,6,2,15
2014 Winter Olympics,58,Latvia,LAT,57,4,1,8,13
2014 Winter Olympics,58,Lebanon,LBN,2,0,0,0,0
2014 Winter Olympics,58,Liechtenstein,LIE,4,0,0,0,0
2014 Winter Olympics,58,Lithuania,LTU,9,0,0,0,0
2014 Winter Olympics,58,Luxembourg,LUX,1,0,0,0,0
2014 Winter Olympics,58,Morocco,MAR,2,0,0,0,0
2014 Winter Olympics,58,Republic of Moldova,MDA,4,0,0,0,0
2014 Winter Olympics,58,Mexico,MEX,1,0,0,0,0
2014 Winter Olympics,58,Mongolia,MGL,2,0,0,0,0
2014 Winter Olympics,58,North Macedonia,MKD,3,0,0,0,0
2014 Winter Olympics,58,Malta,MLT,1,0,0,0,0
2014 Winter Olympics,58,Montenegro,MNE,2,0,0,0,0
2014 Winter Olympics,58,Monaco,MON,5,0,0,0,0
2014 Winter Olympics,58,Netherlands,NED,41,14,7,9,30
2014 Winter Olympics,58,Nepal,NEP,1,0,0,0,0
2014 Winter Olympics,58,Norway,NOR,112,18,9,9,36
2014 Winter Olympics,58,New Zealand,NZL,15,0,0,0,0
2014 Winter Olympics,58,Pakistan,PAK,1,0,0,0,0
2014 Winter Olympics,58,Paraguay,PAR,1,0,0,0,0
2014 Winter Olympics,58,Peru,PER,3,0,0,0,0
2014 Winter Olympics,58,Philippines,PHI,1,0,0,0,0
2014 Winter Olympics,58,Poland,POL,58,4,4,4,12
2014 Winter Olympics,58,Portugal,POR,2,0,0,0,0
2014 Winter Olympics,58,Romania,ROU,22,0,0,0,0
2014 Winter Olympics,58,Russian Federation,RUS,220,24,18,13,55
2014 Winter Olympics,58,Slovenia,SLO,61,2,2,4,8
2014 Winter Olympics,58,San Marino,SMR,2,0,0,0,0
2014 Winter Olympics,58,Serbia,SRB,8,0,0,0,0
2014 Winter Olympics,58,Switzerland,SUI,156,8,2,22,32
2014 Winter Olympics,58,Slovakia,SVK,62,1,0,0,1
2014 Winter Olympics,58,Sweden,SWE,104,8,35,12,55
2014 Winter Olympics,58,Tonga,TGA,1,0,0,0,0
2014 Winter Olympics,58,Thailand,THA,2,0,0,0,0
2014 Winter Olympics,58,Tajikistan,TJK,1,0,0,0,0
2014 Winter Olympics,58,Timor-Leste,TLS,1,0,0,0,0
2014 Winter Olympics,58,Togo,TOG,2,0,0,0,0
2014 Winter Olympics,58,Chinese Taipei,TPE,3,0,0,0,0
2014 Winter Olympics,58,Türkiye,TUR,6,0,0,0,0
2014 Winter Olympics,58,Ukraine,UKR,43,4,0,1,5
2014 Winter Olympics,58,United States,USA,228,10,38,18,66
2014 Winter Olympics,58,Uzbekistan,UZB,3,0,0,0,0
2014 Winter Olympics,58,Venezuela,VEN,1,0,0,0,0
2014 Winter Olympics,58,Zimbabwe,ZIM,1,0,0,0,0
2016 Summer Olympics,59,Afghanistan,AFG,3,0,0,0,0
2016 Summer Olympics,59,Albania,ALB,6,0,0,0,0
2016 Summer Olympics,59,Algeria,ALG,68,0,2,0,2
2016 Summer Olympics,59,Andorra,AND,4,0,0,0,0
2016 Summer Olympics,59,Angola,ANG,26,0,0,0,0
2016 Summer Olympics,59,Antigua and Barbuda,ANT,9,0,0,0,0
2016 Summer Olympics,59,Argentina,ARG,223,21,1,0,22
2016 Summer Olympics,59,Armenia,ARM,32,1,3,0,4
2016 Summer Olympics,59,Aruba,ARU,7,0,0,0,0
2016 Summer Olympics,59,American Samoa,ASA,4,0,0,0,0
2016 Summer Olympics,59,Australia,AUS,429,23,34,25,82
2016 Summer Olympics,59,Austria,AUT,71,0,0,2,2
2016 Summer Olympics,59,Azerbaijan,AZE,56,1,7,10,18
2016 Summer Olympics,59,The Bahamas,BAH,29,1,0,5,6
2016 Summer Olympics,59,Bangladesh,BAN,7,0,0,0,0
2016 Summer Olympics,59,Barbados,BAR,11,0,0,0,0
2016 Summer Olympics,59,Burundi,BDI,9,0,1,0,1
2016 Summer Olympics,59,Belgium,BEL,106,2,19,2,23
2016 Summer Olympics,59,Benin,BEN,6,0,0,0,0
2016 Summer Olympics,59,Bermuda,BER,8,0,0,0,0
2016 Summer Olympics,59,Bhutan,BHU,2,0,0,0,0
2016 Summer Olympics,59,Bosnia and Herzegovina,BIH,11,0,0,0,0
2016 Summer Olympics,59,Belize,BIZ,3,0,0,0,0
2016 Summer Olympics,59,Belarus,BLR,123,1,4,7,12
2016 Summer Olympics,59,Bolivia,BOL,12,0,0,0,0
2016 Summer Olympics,59,Botswana,BOT,12,0,0,0,0
2016 Summer Olympics,59,Brazil,BRA,475,42,8,6,56
2016 Summer Olympics,59,Bahrain,BRN,34,1,1,0,2
2016 Summer Olympics,59,Brunei Darussalam,BRU,3,0,0,0,0
2016 Summer Olympics,59,Bulgaria,BUL,51,0,1,6,7
2016 Summer Olympics,59,Burkina Faso,BUR,5,0,0,0,0
2016 Summer Olympics,59,Central African Republic,CAF,6,0,0,0,0
2016 Summer Olympics,59,Cambodia,CAM,6,0,0,0,0
2016 Summer Olympics,59,Canada,CAN,316,4,4,65,73
2016 Summer Olympics,59,Cayman Islands,CAY,5,0,0,0,0
2016 Summer Olympics,59,Congo,CGO,10,0,0,0,0
2016 Summer Olympics,59,Chad,CHA,2,0,0,0,0
2016 Summer Olympics,59,Chile,CHI,42,0,0,0,0
2016 Summer Olympics,59,People's Republic of China,CHN,400,46,30,37,113
2016 Summer Olympics,59,Côte d'Ivoire,CIV,12,1,0,1,2
2016 Summer Olympics,59,Cameroon,CMR,24,0,0,0,0
2016 Summer Olympics,59,Democratic Republic of the Congo,COD,4,0,0,0,0
2016 Summer Olympics,59,Cook Islands,COK,9,0,0,0,0
2016 Summer Olympics,59,Colombia,COL,154,3,2,3,8
2016 Summer Olympics,59,Comoros,COM,4,0,0,0,0
2016 Summer Olympics,59,Cabo Verde,CPV,5,0,0,0,0
2016 Summer Olympics,59,Costa Rica,CRC,11,0,0,0,0
2016 Summer Olympics,59,Croatia,CRO,87,7,15,2,24
2016 Summer Olympics,59,Cuba,CUB,119,5,2,4,11
2016 Summer Olympics,59,Cyprus,CYP,16,0,0,0,0
2016 Summer Olympics,59,Czechia,CZE,104,1,2,12,15
2016 Summer Olympics,59,Denmark,DEN,123,15,10,16,41
2016 Summer Olympics,59,Djibouti,DJI,7,0,0,0,0
2016 Summer Olympics,59,Dominica,DMA,2,0,0,0,0
2016 Summer Olympics,59,Dominican Republic,DOM,26,0,0,1,1
2016 Summer Olympics,59,Ecuador,ECU,37,0,0,0,0
2016 Summer Olympics,59,Egypt,EGY,121,0,0,3,3
2016 Summer Olympics,59,Refugee Olympic Team,EOR,10,0,0,0,0
2016 Summer Olympics,59,Eritrea,ERI,12,0,0,0,0
2016 Summer Olympics,59,El Salvador,ESA,8,0,0,0,0
2016 Summer Olympics,59,Spain,ESP,311,9,19,17,45
2016 Summer Olympics,59,Estonia,EST,46,0,0,4,4
2016 Summer Olympics,59,Ethiopia,ETH,38,1,2,5,8
2016 Summer Olympics,59,Fiji,FIJ,54,13,0,0,13
2016 Summer Olympics,59,Finland,FIN,54,0,0,1,1
2016 Summer Olympics,59,France,FRA,401,20,55,21,96
2016 Summer Olympics,59,Federated States of Micronesia,FSM,5,0,0,0,0
2016 Summer Olympics,59,Gabon,GAB,6,0,0,0,0
2016 Summer Olympics,59,The Gambia,GAM,4,0,0,0,0
2016 Summer Olympics,59,Great Britain,GBR,364,67,55,26,148
2016 Summer Olympics,59,Guinea Bissau,GBS,5,0,0,0,0
2016 Summer Olympics,59,Georgia,GEO,40,2,1,4,7
2016 Summer Olympics,59,Equatorial Guinea,GEQ,2,0,0,0,0
2016 Summer Olympics,59,Germany,GER,432,53,48,71,172
2016 Summer Olympics,59,Ghana,GHA,13,0,0,0,0
2016 Summer Olympics,59,Greece,GRE,94,3,1,3,7
2016 Summer Olympics,59,Grenada,GRN,7,0,1,0,1
2016 Summer Olympics,59,Guatemala,GUA,21,0,0,0,0
2016 Summer Olympics,59,Guinea,GUI,5,0,0,0,0
2016 Summer Olympics,59,Guam,GUM,5,0,0,0,0
2016 Summer Olympics,59,Guyana,GUY,6,0,0,0,0
2016 Summer Olympics,59,Haiti,HAI,10,0,0,0,0
2016 Summer Olympics,59,"Hong Kong, China",HKG,37,0,0,0,0
2016 Summer Olympics,59,Honduras,HON,29,0,0,0,0
2016 Summer Olympics,59,Hungary,HUN,154,12,3,7,22
2016 Summer Olympics,59,Indonesia,INA,28,2,2,0,4
2016 Summer Olympics,59,India,IND,117,0,1,1,2
2016 Summer Olympics,59,IOA,IOA,9,1,0,1,2
2016 Summer Olympics,59,Islamic Republic of Iran,IRI,63,3,1,4,8
2016 Summer Olympics,59,Ireland,IRL,79,0,3,0,3
2016 Summer Olympics,59,Iraq,IRQ,26,0,0,0,0
2016 Summer Olympics,59,Iceland,ISL,8,0,0,0,0
2016 Summer Olympics,59,Israel,ISR,47,0,0,2,2
2016 Summer Olympics,59,United States Virgin Islands,ISV,7,0,0,0,0
2016 Summer Olympics,59,Italy,ITA,309,8,40,24,72
2016 Summer Olympics,59,British Virgin Islands,IVB,4,0,0,0,0
2016 Summer Olympics,59,Jamaica,JAM,56,11,17,2,30
2016 Summer Olympics,59,Jordan,JOR,8,1,0,0,1
2016 Summer Olympics,59,Japan,JPN,344,17,13,35,65
2016 Summer Olympics,59,Kazakhstan,KAZ,101,2,5,10,17
2016 Summer Olympics,59,Kenya,KEN,80,6,6,1,13
2016 Summer Olympics,59,Kyrgyzstan,KGZ,19,0,0,0,0
2016 Summer Olympics,59,Kiribati,KIR,3,0,0,0,0
2016 Summer Olympics,59,Republic of Korea,KOR,213,13,3,10,26
2016 Summer Olympics,59,Kosovo,KOS,8,1,0,0,1
2016 Summer Olympics,59,Kingdom of Saudi Arabia,KSA,11,0,0,0,0
2016 Summer Olympics,59,Lao People's Democratic Republic,LAO,6,0,0,0,0
2016 Summer Olympics,59,Latvia,LAT,32,0,0,0,0
2016 Summer Olympics,59,Libya,LBA,7,0,0,0,0
2016 Summer Olympics,59,Lebanon,LBN,9,0,0,0,0
2016 Summer Olympics,59,Liberia,LBR,2,0,0,0,0
2016 Summer Olympics,59,Saint Lucia,LCA,5,0,0,0,0
2016 Summer Olympics,59,Lesotho,LES,8,0,0,0,0
2016 Summer Olympics,59,Liechtenstein,LIE,3,0,0,0,0
2016 Summer Olympics,59,Lithuania,LTU,67,0,2,5,7
2016 Summer Olympics,59,Luxembourg,LUX,10,0,0,0,0
2016 Summer Olympics,59,Madagascar,MAD,6,0,0,0,0
2016 Summer Olympics,59,Morocco,MAR,49,0,0,1,1
2016 Summer Olympics,59,Malaysia,MAS,32,0,7,1,8
2016 Summer Olympics,59,Malawi,MAW,5,0,0,0,0
2016 Summer Olympics,59,Republic of Moldova,MDA,23,0,0,0,0
2016 Summer Olympics,59,Maldives,MDV,4,0,0,0,0
2016 Summer Olympics,59,Mexico,MEX,126,0,3,2,5
2016 Summer Olympics,59,Mongolia,MGL,43,0,1,1,2
2016 Summer Olympics,59,Marshall Islands,MHL,5,0,0,0,0
2016 Summer Olympics,59,North Macedonia,MKD,6,0,0,0,0
2016 Summer Olympics,59,Mali,MLI,6,0,0,0,0
2016 Summer Olympics,59,Malta,MLT,7,0,0,0,0
2016 Summer Olympics,59,Montenegro,MNE,35,0,0,0,0
2016 Summer Olympics,59,Monaco,MON,3,0,0,0,0
2016 Summer Olympics,59,Mozambique,MOZ,6,0,0,0,0
2016 Summer Olympics,59,Mauritius,MRI,11,0,0,0,0
2016 Summer Olympics,59,Mauritania,MTN,2,0,0,0,0
2016 Summer Olympics,59,Myanmar,MYA,7,0,0,0,0
2016 Summer Olympics,59,Namibia,NAM,10,0,0,0,0
2016 Summer Olympics,59,Nicaragua,NCA,5,0,0,0,0
2016 Summer Olympics,59,Netherlands,NED,243,9,28,13,50
2016 Summer Olympics,59,Nepal,NEP,7,0,0,0,0
2016 Summer Olympics,59,Nigeria,NGR,76,0,0,22,22
2016 Summer Olympics,59,Niger,NIG,6,0,1,0,1
2016 Summer Olympics,59,Norway,NOR,62,0,0,19,19
2016 Summer Olympics,59,Nauru,NRU,2,0,0,0,0
2016 Summer Olympics,59,New Zealand,NZL,205,6,25,5,36
2016 Summer Olympics,59,Oman,OMA,4,0,0,0,0
2016 Summer Olympics,59,Pakistan,PAK,7,0,0,0,0
2016 Summer Olympics,59,Panama,PAN,10,0,0,0,0
2016 Summer Olympics,59,Paraguay,PAR,11,0,0,0,0
2016 Summer Olympics,59,Peru,PER,29,0,0,0,0
2016 Summer Olympics,59,Philippines,PHI,13,0,1,0,1
2016 Summer Olympics,59,Palestine,PLE,6,0,0,0,0
2016 Summer Olympics,59,Palau,PLW,5,0,0,0,0
2016 Summer Olympics,59,Papua New Guinea,PNG,8,0,0,0,0
2016 Summer Olympics,59,Poland,POL,236,3,3,10,16
2016 Summer Olympics,59,Portugal,POR,95,0,0,1,1
2016 Summer Olympics,59,Democratic People's Republic of Korea,PRK,31,2,3,2,7
2016 Summer Olympics,59,Puerto Rico,PUR,41,1,0,0,1
2016 Summer Olympics,59,Qatar,QAT,38,0,1,0,1
2016 Summer Olympics,59,Romania,ROU,95,4,2,10,16
2016 Summer Olympics,59,South Africa,RSA,146,2,7,14,23
2016 Summer Olympics,59,Russian Federation,RUS,285,53,28,35,116
2016 Summer Olympics,59,Rwanda,RWA,7,0,0,0,0
2016 Summer Olympics,59,Samoa,SAM,8,0,0,0,0
2016 Summer Olympics,59,Senegal,SEN,22,0,0,0,0
2016 Summer Olympics,59,Seychelles,SEY,10,0,0,0,0
2016 Summer Olympics,59,Singapore,SGP,25,1,0,0,1
2016 Summer Olympics,59,Saint Kitts and Nevis,SKN,6,0,0,0,0
2016 Summer Olympics,59,Sierra Leone,SLE,4,0,0,0,0
2016 Summer Olympics,59,Slovenia,SLO,63,1,2,1,4
2016 Summer Olympics,59,San Marino,SMR,4,0,0,0,0
2016 Summer Olympics,59,Solomon Islands,SOL,3,0,0,0,0
2016 Summer Olympics,59,Somalia,SOM,2,0,0,0,0
2016 Summer Olympics,59,Serbia,SRB,103,14,27,13,54
2016 Summer Olympics,59,Sri Lanka,SRI,9,0,0,0,0
2016 Summer Olympics,59,South Sudan,SSD,3,0,0,0,0
2016 Summer Olympics,59,São Tomé and Príncipe,STP,3,0,0,0,0
2016 Summer Olympics,59,Sudan,SUD,6,0,0,0,0
2016 Summer Olympics,59,Switzerland,SUI,102,6,3,2,11
2016 Summer Olympics,59,Suriname,SUR,6,0,0,0,0
2016 Summer Olympics,59,Slovakia,SVK,51,3,5,0,8
2016 Summer Olympics,59,Sweden,SWE,163,2,27,3,32
2016 Summer Olympics,59,Eswatini,SWZ,2,0,0,0,0
2016 Summer Olympics,59,Syrian Arab Republic,SYR,7,0,0,0,0
2016 Summer Olympics,59,United Republic of Tanzania,TAN,7,0,0,0,0
2016 Summer Olympics,59,Tonga,TGA,7,0,0,0,0
2016 Summer Olympics,59,Thailand,THA,54,2,2,2,6
2016 Summer Olympics,59,Tajikistan,TJK,7,1,0,0,1
2016 Summer Olympics,59,Turkmenistan,TKM,9,0,0,0,0
2016 Summer Olympics,59,Timor-Leste,TLS,3,0,0,0,0
2016 Summer Olympics,59,Togo,TOG,5,0,0,0,0
2016 Summer Olympics,59,Chinese Taipei,TPE,56,1,0,4,5
2016 Summer Olympics,59,Trinidad and Tobago,TTO,28,0,0,1,1
2016 Summer Olympics,59,Tunisia,TUN,61,0,0,3,3
2016 Summer Olympics,59,Türkiye,TUR,101,1,3,4,8
2016 Summer Olympics,59,Tuvalu,TUV,1,0,0,0,0
2016 Summer Olympics,59,United Arab Emirates,UAE,13,0,0,1,1
2016 Summer Olympics,59,Uganda,UGA,21,0,0,0,0
2016 Summer Olympics,59,Ukraine,UKR,205,2,8,5,15
2016 Summer Olympics,59,Uruguay,URU,17,0,0,0,0
2016 Summer Olympics,59,United States,USA,560,139,54,71,264
2016 Summer Olympics,59,Uzbekistan,UZB,70,4,2,7,13
2016 Summer Olympics,59,Vanuatu,VAN,4,0,0,0,0
2016 Summer Olympics,59,Venezuela,VEN,86,0,2,1,3
2016 Summer Olympics,59,Vietnam,VIE,22,1,1,0,2
2016 Summer Olympics,59,Saint Vincent and the Grenadines,VIN,4,0,0,0,0
2016 Summer Olympics,59,Yemen,YEM,3,0,0,0,0
2016 Summer Olympics,59,Zambia,ZAM,7,0,0,0,0
2016 Summer Olympics,59,Zimbabwe,ZIM,35,0,0,0,0
2018 Winter Olympics,60,Albania,ALB,2,0,0,0,0
2018 Winter Olympics,60,Andorra,AND,5,0,0,0,0
2018 Winter Olympics,60,Argentina,ARG,7,0,0,0,0
2018 Winter Olympics,60,Armenia,ARM,3,0,0,0,0
2018 Winter Olympics,60,Australia,AUS,50,0,2,1,3
2018 Winter Olympics,60,Austria,AUT,102,5,9,12,26
2018 Winter Olympics,60,Azerbaijan,AZE,1,0,0,0,0
2018 Winter Olympics,60,Belgium,BEL,22,0,1,0,1
2018 Winter Olympics,60,Bermuda,BER,1,0,0,0,0
2018 Winter Olympics,60,Bosnia and Herzegovina,BIH,4,0,0,0,0
2018 Winter Olympics,60,Belarus,BLR,32,5,1,0,6
2018 Winter Olympics,60,Bolivia,BOL,2,0,0,0,0
2018 Winter Olympics,60,Brazil,BRA,9,0,0,0,0
2018 Winter Olympics,60,Bulgaria,BUL,20,0,0,0,0
2018 Winter Olympics,60,Canada,CAN,225,30,33,40,103
2018 Winter Olympics,60,Chile,CHI,7,0,0,0,0
2018 Winter Olympics,60,People's Republic of China,CHN,80,1,11,2,14
2018 Winter Olympics,60,Colombia,COL,4,0,0,0,0
2018 Winter Olympics,60,Korea,COR,35,0,0,0,0
2018 Winter Olympics,60,Croatia,CRO,19,0,0,0,0
2018 Winter Olympics,60,Cyprus,CYP,1,0,0,0,0
2018 Winter Olympics,60,Czechia,CZE,93,2,2,3,7
2018 Winter Olympics,60,Denmark,DEN,17,0,0,0,0
2018 Winter Olympics,60,Ecuador,ECU,1,0,0,0,0
2018 Winter Olympics,60,Eritrea,ERI,1,0,0,0,0
2018 Winter Olympics,60,Spain,ESP,13,0,0,2,2
2018 Winter Olympics,60,Estonia,EST,20,0,0,0,0
2018 Winter Olympics,60,Finland,FIN,100,1,1,26,28
2018 Winter Olympics,60,France,FRA,102,8,5,13,26
2018 Winter Olympics,60,Great Britain,GBR,58,1,0,4,5
2018 Winter Olympics,60,Georgia,GEO,4,0,0,0,0
2018 Winter Olympics,60,Germany,GER,146,27,40,11,78
2018 Winter Olympics,60,Ghana,GHA,1,0,0,0,0
2018 Winter Olympics,60,Greece,GRE,4,0,0,0,0
2018 Winter Olympics,60,"Hong Kong, China",HKG,1,0,0,0,0
2018 Winter Olympics,60,Hungary,HUN,19,5,0,0,5
2018 Winter Olympics,60,India,IND,2,0,0,0,0
2018 Winter Olympics,60,Islamic Republic of Iran,IRI,4,0,0,0,0
2018 Winter Olympics,60,Ireland,IRL,5,0,0,0,0
2018 Winter Olympics,60,Iceland,ISL,5,0,0,0,0
2018 Winter Olympics,60,Israel,ISR,10,0,0,0,0
2018 Winter Olympics,60,Italy,ITA,118,3,6,8,17
2018 Winter Olympics,60,Jamaica,JAM,3,0,0,0,0
2018 Winter Olympics,60,Japan,JPN,123,7,5,8,20
2018 Winter Olympics,60,Kazakhstan,KAZ,45,0,0,1,1
2018 Winter Olympics,60,Kenya,KEN,1,0,0,0,0
2018 Winter Olympics,60,Kyrgyzstan,KGZ,2,0,0,0,0
2018 Winter Olympics,60,Republic of Korea,KOR,122,9,18,4,31
2018 Winter Olympics,60,Kosovo,KOS,1,0,0,0,0
2018 Winter Olympics,60,Latvia,LAT,34,0,0,2,2
2018 Winter Olympics,60,Lebanon,LBN,3,0,0,0,0
2018 Winter Olympics,60,Liechtenstein,LIE,3,0,0,1,1
2018 Winter Olympics,60,Lithuania,LTU,9,0,0,0,0
2018 Winter Olympics,60,Luxembourg,LUX,1,0,0,0,0
2018 Winter Olympics,60,Madagascar,MAD,1,0,0,0,0
2018 Winter Olympics,60,Morocco,MAR,2,0,0,0,0
2018 Winter Olympics,60,Malaysia,MAS,2,0,0,0,0
2018 Winter Olympics,60,Republic of Moldova,MDA,2,0,0,0,0
2018 Winter Olympics,60,Mexico,MEX,4,0,0,0,0
2018 Winter Olympics,60,Mongolia,MGL,2,0,0,0,0
2018 Winter Olympics,60,North Macedonia,MKD,3,0,0,0,0
2018 Winter Olympics,60,Malta,MLT,1,0,0,0,0
2018 Winter Olympics,60,Montenegro,MNE,3,0,0,0,0
2018 Winter Olympics,60,Monaco,MON,4,0,0,0,0
2018 Winter Olympics,60,Netherlands,NED,33,8,9,13,30
2018 Winter Olympics,60,Nigeria,NGR,4,0,0,0,0
2018 Winter Olympics,60,Norway,NOR,102,27,23,18,68
2018 Winter Olympics,60,New Zealand,NZL,20,0,0,2,2
2018 Winter Olympics,60,Pakistan,PAK,2,0,0,0,0
2018 Winter Olympics,60,Philippines,PHI,2,0,0,0,0
2018 Winter Olympics,60,Poland,POL,61,1,0,4,5
2018 Winter Olympics,60,Portugal,POR,2,0,0,0,0
2018 Winter Olympics,60,Democratic People's Republic of Korea,PRK,10,0,0,0,0
2018 Winter Olympics,60,Puerto Rico,PUR,1,0,0,0,0
2018 Winter Olympics,60,ROC,ROC,168,26,24,12,62
2018 Winter Olympics,60,Romania,ROU,28,0,0,0,0
2018 Winter Olympics,60,South Africa,RSA,1,0,0,0,0
2018 Winter Olympics,60,Singapore,SGP,1,0,0,0,0
2018 Winter Olympics,60,Slovenia,SLO,71,0,1,1,2
2018 Winter Olympics,60,San Marino,SMR,1,0,0,0,0
2018 Winter Olympics,60,Serbia,SRB,4,0,0,0,0
2018 Winter Olympics,60,Switzerland,SUI,163,9,7,8,24
2018 Winter Olympics,60,Slovakia,SVK,55,1,2,0,3
2018 Winter Olympics,60,Sweden,SWE,110,14,17,1,32
2018 Winter Olympics,60,Tonga,TGA,1,0,0,0,0
2018 Winter Olympics,60,Thailand,THA,4,0,0,0,0
2018 Winter Olympics,60,Timor-Leste,TLS,1,0,0,0,0
2018 Winter Olympics,60,Togo,TOG,1,0,0,0,0
2018 Winter Olympics,60,Chinese Taipei,TPE,4,0,0,0,0
2018 Winter Olympics,60,Türkiye,TUR,8,0,0,0,0
2018 Winter Olympics,60,Ukraine,UKR,32,1,0,0,1
2018 Winter Olympics,60,United States,USA,235,36,9,23,68
2018 Winter Olympics,60,Uzbekistan,UZB,2,0,0,0,0
2020 Summer Olympics,61,Afghanistan,AFG,5,0,0,0,0
2020 Summer Olympics,61,Albania,ALB,9,0,0,0,0
2020 Summer Olympics,61,Algeria,ALG,41,0,0,0,0
2020 Summer Olympics,61,Andorra,AND,2,0,0,0,0
2020 Summer Olympics,61,Angola,ANG,20,0,0,0,0
2020 Summer Olympics,61,Antigua and Barbuda,ANT,6,0,0,0,0
2020 Summer Olympics,61,Argentina,ARG,189,0,18,25,43
2020 Summer Olympics,61,Armenia,ARM,17,0,2,2,4
2020 Summer Olympics,61,Aruba,ARU,3,0,0,0,0
2020 Summer Olympics,61,American Samoa,ASA,6,0,0,0,0
2020 Summer Olympics,61,Australia,AUS,487,36,28,66,130
2020 Summer Olympics,61,Austria,AUT,75,1,1,5,7
2020 Summer Olympics,61,Azerbaijan,AZE,44,0,3,4,7
2020 Summer Olympics,61,The Bahamas,BAH,16,2,0,0,2
2020 Summer Olympics,61,Bangladesh,BAN,6,0,0,0,0
2020 Summer Olympics,61,Barbados,BAR,8,0,0,0,0
2020 Summer Olympics,61,Burundi,BDI,6,0,0,0,0
2020 Summer Olympics,61,Belgium,BEL,125,20,1,6,27
2020 Summer Olympics,61,Benin,BEN,7,0,0,0,0
2020 Summer Olympics,61,Bermuda,BER,2,1,0,0,1
2020 Summer Olympics,61,Bhutan,BHU,4,0,0,0,0
2020 Summer Olympics,61,Bosnia and Herzegovina,BIH,7,0,0,0,0
2020 Summer Olympics,61,Belize,BIZ,3,0,0,0,0
2020 Summer Olympics,61,Belarus,BLR,105,1,6,3,10
2020 Summer Olympics,61,Bolivia,BOL,5,0,0,0,0
2020 Summer Olympics,61,Botswana,BOT,13,0,0,5,5
2020 Summer Olympics,61,Brazil,BRA,316,29,17,9,55
2020 Summer Olympics,61,Bahrain,BRN,33,0,1,0,1
2020 Summer Olympics,61,Brunei Darussalam,BRU,2,0,0,0,0
2020 Summer Olympics,61,Bulgaria,BUL,42,7,1,2,10
2020 Summer Olympics,61,Burkina Faso,BUR,7,0,0,1,1
2020 Summer Olympics,61,Central African Republic,CAF,2,0,0,0,0
2020 Summer Olympics,61,Cambodia,CAM,3,0,0,0,0
2020 Summer Olympics,61,Canada,CAN,383,36,18,31,85
2020 Summer Olympics,61,Cayman Islands,CAY,5,0,0,0,0
2020 Summer Olympics,61,Congo,CGO,3,0,0,0,0
2020 Summer Olympics,61,Chad,CHA,3,0,0,0,0
2020 Summer Olympics,61,Chile,CHI,57,0,0,0,0
2020 Summer Olympics,61,People's Republic of China,CHN,418,58,49,38,145
2020 Summer Olympics,61,Côte d'Ivoire,CIV,31,0,0,1,1
2020 Summer Olympics,61,Cameroon,CMR,12,0,0,0,0
2020 Summer Olympics,61,Democratic Republic of the Congo,COD,7,0,0,0,0
2020 Summer Olympics,61,Cook Islands,COK,6,0,0,0,0
2020 Summer Olympics,61,Colombia,COL,68,0,4,1,5
2020 Summer Olympics,61,Comoros,COM,3,0,0,0,0
2020 Summer Olympics,61,Cabo Verde,CPV,6,0,0,0,0
2020 Summer Olympics,61,Costa Rica,CRC,14,0,0,0,0
2020 Summer Olympics,61,Croatia,CRO,60,5,4,2,11
2020 Summer Olympics,61,Cuba,CUB,69,8,3,5,16
2020 Summer Olympics,61,Cyprus,CYP,15,0,0,0,0
2020 Summer Olympics,61,Czechia,CZE,114,5,4,4,13
2020 Summer Olympics,61,Denmark,DEN,108,4,23,5,32
2020 Summer Olympics,61,Djibouti,DJI,4,0,0,0,0
2020 Summer Olympics,61,Dominica,DMA,2,0,0,0,0
2020 Summer Olympics,61,Dominican Republic,DOM,65,0,7,25,32
2020 Summer Olympics,61,Ecuador,ECU,47,2,1,0,3
2020 Summer Olympics,61,Egypt,EGY,141,1,1,4,6
2020 Summer Olympics,61,Refugee Olympic Team,EOR,29,0,0,0,0
2020 Summer Olympics,61,Eritrea,ERI,13,0,0,0,0
2020 Summer Olympics,61,El Salvador,ESA,5,0,0,0,0
2020 Summer Olympics,61,Spain,ESP,334,4,44,22,70
2020 Summer Olympics,61,Estonia,EST,33,4,0,1,5
2020 Summer Olympics,61,Ethiopia,ETH,36,1,1,2,4
2020 Summer Olympics,61,Fiji,FIJ,32,13,0,13,26
2020 Summer Olympics,61,Finland,FIN,45,0,0,2,2
2020 Summer Olympics,61,France,FRA,393,65,42,31,138
2020 Summer Olympics,61,Federated States of Micronesia,FSM,3,0,0,0,0
2020 Summer Olympics,61,Gabon,GAB,5,0,0,0,0
2020 Summer Olympics,61,The Gambia,GAM,4,0,0,0,0
2020 Summer Olympics,61,Great Britain,GBR,390,40,35,57,132
2020 Summer Olympics,61,Guinea Bissau,GBS,4,0,0,0,0
2020 Summer Olympics,61,Georgia,GEO,33,2,5,1,8
2020 Summer Olympics,61,Equatorial Guinea,GEQ,3,0,0,0,0
2020 Summer Olympics,61,Germany,GER,410,20,25,34,79
2020 Summer Olympics,61,Ghana,GHA,14,0,0,1,1
2020 Summer Olympics,61,Greece,GRE,82,2,13,1,16
2020 Summer Olympics,61,Grenada,GRN,6,0,0,1,1
2020 Summer Olympics,61,Guatemala,GUA,24,0,0,0,0
2020 Summer Olympics,61,Guinea,GUI,5,0,0,0,0
2020 Summer Olympics,61,Guam,GUM,5,0,0,0,0
2020 Summer Olympics,61,Guyana,GUY,7,0,0,0,0
2020 Summer Olympics,61,Haiti,HAI,6,0,0,0,0
2020 Summer Olympics,61,"Hong Kong, China",HKG,43,1,2,5,8
2020 Summer Olympics,61,Honduras,HON,27,0,0,0,0
2020 Summer Olympics,61,Hungary,HUN,172,9,7,35,51
2020 Summer Olympics,61,Indonesia,INA,28,2,1,3,6
2020 Summer Olympics,61,India,IND,125,1,2,21,24
2020 Summer Olympics,61,Islamic Republic of Iran,IRI,65,3,2,2,7
2020 Summer Olympics,61,Ireland,IRL,121,3,0,5,8
2020 Summer Olympics,61,Iraq,IRQ,3,0,0,0,0
2020 Summer Olympics,61,Iceland,ISL,4,0,0,0,0
2020 Summer Olympics,61,Israel,ISR,89,2,0,12,14
2020 Summer Olympics,61,United States Virgin Islands,ISV,4,0,0,0,0
2020 Summer Olympics,61,Italy,ITA,379,21,17,38,76
2020 Summer Olympics,61,British Virgin Islands,IVB,3,0,0,0,0
2020 Summer Olympics,61,Jamaica,JAM,59,9,1,11,21
2020 Summer Olympics,61,Jordan,JOR,14,0,1,1,2
2020 Summer Olympics,61,Japan,JPN,610,68,41,22,131
2020 Summer Olympics,61,Kazakhstan,KAZ,97,0,0,8,8
2020 Summer Olympics,61,Kenya,KEN,86,4,4,2,10
2020 Summer Olympics,61,Kyrgyzstan,KGZ,16,0,2,1,3
2020 Summer Olympics,61,Kiribati,KIR,3,0,0,0,0
2020 Summer Olympics,61,Republic of Korea,KOR,238,14,7,17,38
2020 Summer Olympics,61,Kosovo,KOS,11,2,0,0,2
2020 Summer Olympics,61,Kingdom of Saudi Arabia,KSA,33,0,1,0,1
2020 Summer Olympics,61,Kuwait,KUW,9,0,0,1,1
2020 Summer Olympics,61,Lao People's Democratic Republic,LAO,4,0,0,0,0
2020 Summer Olympics,61,Latvia,LAT,33,4,0,1,5
2020 Summer Olympics,61,Libya,LBA,4,0,0,0,0
2020 Summer Olympics,61,Lebanon,LBN,6,0,0,0,0
2020 Summer Olympics,61,Liberia,LBR,3,0,0,0,0
2020 Summer Olympics,61,Saint Lucia,LCA,5,0,0,0,0
2020 Summer Olympics,61,Lesotho,LES,2,0,0,0,0
2020 Summer Olympics,61,Liechtenstein,LIE,5,0,0,0,0
2020 Summer Olympics,61,Lithuania,LTU,42,0,1,0,1
2020 Summer Olympics,61,Luxembourg,LUX,12,0,0,0,0
2020 Summer Olympics,61,Madagascar,MAD,6,0,0,0,0
2020 Summer Olympics,61,Morocco,MAR,45,1,0,0,1
2020 Summer Olympics,61,Malaysia,MAS,30,0,1,2,3
2020 Summer Olympics,61,Malawi,MAW,5,0,0,0,0
2020 Summer Olympics,61,Republic of Moldova,MDA,20,0,0,1,1
2020 Summer Olympics,61,Maldives,MDV,4,0,0,0,0
2020 Summer Olympics,61,Mexico,MEX,162,0,0,27,27
2020 Summer Olympics,61,Mongolia,MGL,43,0,1,3,4
2020 Summer Olympics,61,Marshall Islands,MHL,2,0,0,0,0
2020 Summer Olympics,61,North Macedonia,MKD,8,0,1,0,1
2020 Summer Olympics,61,Mali,MLI,4,0,0,0,0
2020 Summer Olympics,61,Malta,MLT,6,0,0,0,0
2020 Summer Olympics,61,Montenegro,MNE,35,0,0,0,0
2020 Summer Olympics,61,Monaco,MON,6,0,0,0,0
2020 Summer Olympics,61,Mozambique,MOZ,10,0,0,0,0
2020 Summer Olympics,61,Mauritius,MRI,8,0,0,0,0
2020 Summer Olympics,61,Mauritania,MTN,2,0,0,0,0
2020 Summer Olympics,61,Myanmar,MYA,2,0,0,0,0
2020 Summer Olympics,61,Namibia,NAM,11,0,1,0,1
2020 Summer Olympics,61,Nicaragua,NCA,8,0,0,0,0
2020 Summer Olympics,61,Netherlands,NED,283,33,22,17,72
2020 Summer Olympics,61,Nepal,NEP,5,0,0,0,0
2020 Summer Olympics,61,Nigeria,NGR,58,0,1,1,2
2020 Summer Olympics,61,Niger,NIG,7,0,0,0,0
2020 Summer Olympics,61,Norway,NOR,93,5,2,16,23
2020 Summer Olympics,61,Nauru,NRU,2,0,0,0,0
2020 Summer Olympics,61,New Zealand,NZL,226,29,28,8,65
2020 Summer Olympics,61,Oman,OMA,5,0,0,0,0
2020 Summer Olympics,61,Pakistan,PAK,10,0,0,0,0
2020 Summer Olympics,61,Panama,PAN,10,0,0,0,0
2020 Summer Olympics,61,Paraguay,PAR,8,0,0,0,0
2020 Summer Olympics,61,Peru,PER,35,0,0,0,0
2020 Summer Olympics,61,Philippines,PHI,19,1,2,1,4
2020 Summer Olympics,61,Palestine,PLE,5,0,0,0,0
2020 Summer Olympics,61,Palau,PLW,3,0,0,0,0
2020 Summer Olympics,61,Papua New Guinea,PNG,8,0,0,0,0
2020 Summer Olympics,61,Poland,POL,212,14,14,8,36
2020 Summer Olympics,61,Portugal,POR,93,1,1,2,4
2020 Summer Olympics,61,Puerto Rico,PUR,37,1,0,0,1
2020 Summer Olympics,61,Qatar,QAT,16,2,0,2,4
2020 Summer Olympics,61,ROC,ROC,337,41,80,27,148
2020 Summer Olympics,61,Romania,ROU,104,2,7,0,9
2020 Summer Olympics,61,South Africa,RSA,180,1,2,0,3
2020 Summer Olympics,61,Rwanda,RWA,5,0,0,0,0
2020 Summer Olympics,61,Samoa,SAM,8,0,0,0,0
2020 Summer Olympics,61,Senegal,SEN,9,0,0,0,0
2020 Summer Olympics,61,Seychelles,SEY,5,0,0,0,0
2020 Summer Olympics,61,Singapore,SGP,23,0,0,0,0
2020 Summer Olympics,61,Saint Kitts and Nevis,SKN,2,0,0,0,0
2020 Summer Olympics,61,Sierra Leone,SLE,4,0,0,0,0
2020 Summer Olympics,61,Slovenia,SLO,53,3,1,1,5
2020 Summer Olympics,61,San Marino,SMR,5,0,2,2,4
2020 Summer Olympics,61,Solomon Islands,SOL,3,0,0,0,0
2020 Summer Olympics,61,Somalia,SOM,2,0,0,0,0
2020 Summer Olympics,61,Serbia,SRB,87,15,1,19,35
2020 Summer Olympics,61,Sri Lanka,SRI,9,0,0,0,0
2020 Summer Olympics,61,South Sudan,SSD,2,0,0,0,0
2020 Summer Olympics,61,São Tomé and Príncipe,STP,3,0,0,0,0
2020 Summer Olympics,61,Sudan,SUD,5,0,0,0,0
2020 Summer Olympics,61,Switzerland,SUI,116,3,5,7,15
2020 Summer Olympics,61,Suriname,SUR,3,0,0,0,0
2020 Summer Olympics,61,Slovakia,SVK,41,1,2,4,7
2020 Summer Olympics,61,Sweden,SWE,135,6,28,0,34
2020 Summer Olympics,61,Eswatini,SWZ,4,0,0,0,0
2020 Summer Olympics,61,Syrian Arab Republic,SYR,6,0,0,1,1
2020 Summer Olympics,61,United Republic of Tanzania,TAN,3,0,0,0,0
2020 Summer Olympics,61,Tonga,TGA,6,0,0,0,0
2020 Summer Olympics,61,Thailand,THA,41,1,0,1,2
2020 Summer Olympics,61,Tajikistan,TJK,10,0,0,0,0
2020 Summer Olympics,61,Turkmenistan,TKM,9,0,1,0,1
2020 Summer Olympics,61,Timor-Leste,TLS,3,0,0,0,0
2020 Summer Olympics,61,Togo,TOG,4,0,0,0,0
2020 Summer Olympics,61,Chinese Taipei,TPE,68,3,6,7,16
2020 Summer Olympics,61,Trinidad and Tobago,TTO,31,0,0,0,0
2020 Summer Olympics,61,Tunisia,TUN,63,1,1,0,2
2020 Summer Olympics,61,Türkiye,TUR,107,2,2,9,13
2020 Summer Olympics,61,Tuvalu,TUV,2,0,0,0,0
2020 Summer Olympics,61,United Arab Emirates,UAE,5,0,0,0,0
2020 Summer Olympics,61,Uganda,UGA,25,2,1,1,4
2020 Summer Olympics,61,Ukraine,UKR,153,1,7,21,29
2020 Summer Olympics,61,Uruguay,URU,11,0,0,0,0
2020 Summer Olympics,61,United States,USA,628,113,109,75,297
2020 Summer Olympics,61,Uzbekistan,UZB,67,3,0,2,5
2020 Summer Olympics,61,Vanuatu,VAN,3,0,0,0,0
2020 Summer Olympics,61,Venezuela,VEN,43,1,3,0,4
2020 Summer Olympics,61,Vietnam,VIE,18,0,0,0,0
2020 Summer Olympics,61,Saint Vincent and the Grenadines,VIN,3,0,0,0,0
2020 Summer Olympics,61,Yemen,YEM,5,0,0,0,0
2020 Summer Olympics,61,Zambia,ZAM,30,0,0,0,0
2020 Summer Olympics,61,Zimbabwe,ZIM,5,0,0,0,0
2022 Winter Olympics,62,Albania,ALB,1,0,0,0,0
2022 Winter Olympics,62,Andorra,AND,5,0,0,0,0
2022 Winter Olympics,62,Argentina,ARG,6,0,0,0,0
2022 Winter Olympics,62,Armenia,ARM,6,0,0,0,0
2022 Winter Olympics,62,American Samoa,ASA,1,0,0,0,0
2022 Winter Olympics,62,Australia,AUS,43,1,2,1,4
2022 Winter Olympics,62,Austria,AUT,101,15,10,5,30
2022 Winter Olympics,62,Azerbaijan,AZE,2,0,0,0,0
2022 Winter Olympics,62,Belgium,BEL,19,1,0,1,2
2022 Winter Olympics,62,Bosnia and Herzegovina,BIH,6,0,0,0,0
2022 Winter Olympics,62,Belarus,BLR,26,0,2,0,2
2022 Winter Olympics,62,Bolivia,BOL,2,0,0,0,0
2022 Winter Olympics,62,Brazil,BRA,10,0,0,0,0
2022 Winter Olympics,62,Bulgaria,BUL,15,0,0,0,0
2022 Winter Olympics,62,Canada,CAN,215,33,8,28,69
2022 Winter Olympics,62,Chile,CHI,4,0,0,0,0
2022 Winter Olympics,62,People's Republic of China,CHN,180,14,6,6,26
2022 Winter Olympics,62,Colombia,COL,3,0,0,0,0
2022 Winter Olympics,62,Croatia,CRO,11,0,0,0,0
2022 Winter Olympics,62,Cyprus,CYP,1,0,0,0,0
2022 Winter Olympics,62,Czechia,CZE,114,1,0,1,2
2022 Winter Olympics,62,Denmark,DEN,63,0,0,0,0
2022 Winter Olympics,62,Ecuador,ECU,1,0,0,0,0
2022 Winter Olympics,62,Eritrea,ERI,1,0,0,0,0
2022 Winter Olympics,62,Spain,ESP,14,0,1,0,1
2022 Winter Olympics,62,Estonia,EST,25,0,0,1,1
2022 Winter Olympics,62,Finland,FIN,94,26,3,26,55
2022 Winter Olympics,62,France,FRA,81,6,13,5,24
2022 Winter Olympics,62,Great Britain,GBR,49,5,5,0,10
2022 Winter Olympics,62,Georgia,GEO,9,0,0,0,0
2022 Winter Olympics,62,Germany,GER,143,22,26,12,60
2022 Winter Olympics,62,Ghana,GHA,1,0,0,0,0
2022 Winter Olympics,62,Greece,GRE,5,0,0,0,0
2022 Winter Olympics,62,Haiti,HAI,1,0,0,0,0
2022 Winter Olympics,62,"Hong Kong, China",HKG,3,0,0,0,0
2022 Winter Olympics,62,Hungary,HUN,14,1,0,6,7
2022 Winter Olympics,62,India,IND,1,0,0,0,0
2022 Winter Olympics,62,Islamic Republic of Iran,IRI,2,0,0,0,0
2022 Winter Olympics,62,Ireland,IRL,6,0,0,0,0
2022 Winter Olympics,62,Iceland,ISL,5,0,0,0,0
2022 Winter Olympics,62,Israel,ISR,6,0,0,0,0
2022 Winter Olympics,62,United States Virgin Islands,ISV,1,0,0,0,0
2022 Winter Olympics,62,Italy,ITA,119,3,13,12,28
2022 Winter Olympics,62,Jamaica,JAM,7,0,0,0,0
2022 Winter Olympics,62,Japan,JPN,120,3,13,21,37
2022 Winter Olympics,62,Kazakhstan,KAZ,34,0,0,0,0
2022 Winter Olympics,62,Kyrgyzstan,KGZ,1,0,0,0,0
2022 Winter Olympics,62,Republic of Korea,KOR,65,2,13,2,17
2022 Winter Olympics,62,Kosovo,KOS,2,0,0,0,0
2022 Winter Olympics,62,Kingdom of Saudi Arabia,KSA,1,0,0,0,0
2022 Winter Olympics,62,Latvia,LAT,58,0,0,4,4
2022 Winter Olympics,62,Lebanon,LBN,3,0,0,0,0
2022 Winter Olympics,62,Liechtenstein,LIE,2,0,0,0,0
2022 Winter Olympics,62,Lithuania,LTU,13,0,0,0,0
2022 Winter Olympics,62,Luxembourg,LUX,2,0,0,0,0
2022 Winter Olympics,62,Madagascar,MAD,2,0,0,0,0
2022 Winter Olympics,62,Morocco,MAR,1,0,0,0,0
2022 Winter Olympics,62,Malaysia,MAS,2,0,0,0,0
2022 Winter Olympics,62,Republic of Moldova,MDA,5,0,0,0,0
2022 Winter Olympics,62,Mexico,MEX,4,0,0,0,0
2022 Winter Olympics,62,Mongolia,MGL,2,0,0,0,0
2022 Winter Olympics,62,North Macedonia,MKD,2,0,0,0,0
2022 Winter Olympics,62,Malta,MLT,1,0,0,0,0
2022 Winter Olympics,62,Montenegro,MNE,3,0,0,0,0
2022 Winter Olympics,62,Monaco,MON,3,0,0,0,0
2022 Winter Olympics,62,Netherlands,NED,41,12,5,7,24
2022 Winter Olympics,62,Nigeria,NGR,1,0,0,0,0
2022 Winter Olympics,62,Norway,NOR,79,29,12,18,59
2022 Winter Olympics,62,New Zealand,NZL,15,2,1,0,3
2022 Winter Olympics,62,Pakistan,PAK,1,0,0,0,0
2022 Winter Olympics,62,Peru,PER,1,0,0,0,0
2022 Winter Olympics,62,Philippines,PHI,1,0,0,0,0
2022 Winter Olympics,62,Poland,POL,57,0,0,1,1
2022 Winter Olympics,62,Portugal,POR,3,0,0,0,0
2022 Winter Olympics,62,Puerto Rico,PUR,2,0,0,0,0
2022 Winter Olympics,62,ROC,ROC,215,29,47,23,99
2022 Winter Olympics,62,Romania,ROU,21,0,0,0,0
2022 Winter Olympics,62,Slovenia,SLO,42,5,6,2,13
2022 Winter Olympics,62,San Marino,SMR,2,0,0,0,0
2022 Winter Olympics,62,Serbia,SRB,2,0,0,0,0
2022 Winter Olympics,62,Switzerland,SUI,165,7,2,6,15
2022 Winter Olympics,62,Slovakia,SVK,50,1,0,25,26
2022 Winter Olympics,62,Sweden,SWE,114,15,6,13,34
2022 Winter Olympics,62,Thailand,THA,4,0,0,0,0
2022 Winter Olympics,62,Timor-Leste,TLS,1,0,0,0,0
2022 Winter Olympics,62,Chinese Taipei,TPE,4,0,0,0,0
2022 Winter Olympics,62,Trinidad and Tobago,TTO,3,0,0,0,0
2022 Winter Olympics,62,Türkiye,TUR,7,0,0,0,0
2022 Winter Olympics,62,Ukraine,UKR,45,0,1,0,1
2022 Winter Olympics,62,United States,USA,223,12,48,12,72
2022 Winter Olympics,62,Uzbekistan,UZB,1,0,0,0,0
2024 Summer Olympics,63,France,FRA,2042,748,750,803,2301
